# FROM-URL	TO-URL
/ko/docs/AJAX	/ko/docs/Web/Guide/AJAX
/ko/docs/AJAX/Getting_Started	/ko/docs/Web/Guide/AJAX/Getting_Started
/ko/docs/AJAX:Getting_Started	/docs/ko/AJAX/Getting_Started
/ko/docs/A_Basic_RayCaster:input.js	/docs/ko/A_Basic_RayCaster/input.js
/ko/docs/About_JavaScript	/ko/docs/Web/JavaScript/About
/ko/docs/About_the_Document_Object_Model	/ko/docs/Web/API/Document_Object_Model
/ko/docs/Accessibility	/ko/docs/Web/Accessibility
/ko/docs/Accessibility/ARIA	/ko/docs/Web/Accessibility/ARIA
/ko/docs/Accessibility/An_overview_of_accessible_web_applications_and_widgets	/ko/docs/Web/Accessibility/An_overview_of_accessible_web_applications_and_widgets
/ko/docs/Alternative_style_sheets	/ko/docs/Web/CSS/Alternative_style_sheets
/ko/docs/Apps/Manifest	/ko/docs/Web/Apps/Developing/Manifest/Manifest
/ko/docs/Apps/Progressive	/ko/docs/Web/Progressive_web_apps
/ko/docs/Apps/Progressive/Add_to_home_screen	/ko/docs/Web/Progressive_web_apps/Add_to_home_screen
/ko/docs/Apps/Progressive/App_structure	/ko/docs/Web/Progressive_web_apps/App_structure
/ko/docs/Apps/Progressive/Installable_PWAs	/ko/docs/Web/Progressive_web_apps/Installable_PWAs
/ko/docs/Apps/Progressive/Offline_Service_workers	/ko/docs/Web/Progressive_web_apps/Offline_Service_workers
/ko/docs/Apps/Progressive/Re-engageable_Notifications_Push	/ko/docs/Web/Progressive_web_apps/Re-engageable_Notifications_Push
/ko/docs/Apps/Progressive/소개	/ko/docs/Web/Progressive_web_apps/%EC%86%8C%EA%B0%9C
/ko/docs/Archive/B2G_OS/Boot_to_Gecko_developer_phone_guide	/ko/docs/Archive/B2G_OS/Phone_guide
/ko/docs/Archive/B2G_OS/Platform/Testing	/ko/docs/Archive/B2G_OS/Automated_testing
/ko/docs/B2G_OS	/ko/docs/Archive/B2G_OS
/ko/docs/B2G_OS/API	/ko/docs/Archive/B2G_OS/API
/ko/docs/B2G_OS/API/Camera_API	/ko/docs/Archive/B2G_OS/API/Camera_API
/ko/docs/B2G_OS/API/Camera_API/Introduction	/ko/docs/Archive/B2G_OS/API/Camera_API/Introduction
/ko/docs/B2G_OS/Application_development	/ko/docs/Archive/B2G_OS/Application_development
/ko/docs/B2G_OS/Apps	/ko/docs/Archive/B2G_OS/Apps
/ko/docs/B2G_OS/Apps/Writing_a_web_app_for_Firefox_OS	/ko/docs/Archive/B2G_OS/Apps/Writing_a_web_app_for_Firefox_OS
/ko/docs/B2G_OS/Boot_to_Gecko_developer_phone_guide	/ko/docs/Archive/B2G_OS/Boot_to_Gecko_developer_phone_guide
/ko/docs/B2G_OS/Building	/ko/docs/Archive/B2G_OS/Building
/ko/docs/B2G_OS/Building_and_installing_Firefox_OS	/ko/docs/Archive/B2G_OS/Building_and_installing_Firefox_OS
/ko/docs/B2G_OS/Debugging	/ko/docs/Archive/B2G_OS/Debugging
/ko/docs/B2G_OS/Debugging/Debugging_B2G_using_gdb	/ko/docs/Archive/B2G_OS/Debugging/Debugging_B2G_using_gdb
/ko/docs/B2G_OS/Dual_boot_of_B2G_and_Android_on_SGS2	/ko/docs/Archive/B2G_OS/Dual_boot_of_B2G_and_Android_on_SGS2
/ko/docs/B2G_OS/Firefox_OS_FAQ	/ko/docs/Archive/B2G_OS/Firefox_OS_FAQ
/ko/docs/B2G_OS/Firefox_OS_build_prerequisites	/ko/docs/Archive/B2G_OS/Firefox_OS_build_prerequisites
/ko/docs/B2G_OS/Installing_on_a_mobile_device	/ko/docs/Archive/B2G_OS/Installing_on_a_mobile_device
/ko/docs/B2G_OS/Introduction	/ko/docs/Archive/B2G_OS/Introduction
/ko/docs/B2G_OS/Pandaboard	/ko/docs/Archive/B2G_OS/Pandaboard
/ko/docs/B2G_OS/Platform	/ko/docs/Archive/B2G_OS/Platform
/ko/docs/B2G_OS/Platform/Architecture	/ko/docs/Archive/B2G_OS/Platform/Architecture
/ko/docs/B2G_OS/Platform/Gonk	/ko/docs/Archive/B2G_OS/Platform/Gonk
/ko/docs/B2G_OS/Platform/Testing	/ko/docs/Archive/B2G_OS/Platform/Testing
/ko/docs/B2G_OS/Porting	/ko/docs/Archive/B2G_OS/Porting
/ko/docs/B2G_OS/Preparing_for_your_first_B2G_build	/ko/docs/Archive/B2G_OS/Preparing_for_your_first_B2G_build
/ko/docs/B2G_OS/Security	/ko/docs/Archive/B2G_OS/Security
/ko/docs/B2G_OS/Security/보안_모델	/ko/docs/Archive/B2G_OS/Security/%EB%B3%B4%EC%95%88_%EB%AA%A8%EB%8D%B8
/ko/docs/B2G_OS/Using_Gaia_in_Firefox	/ko/docs/Archive/B2G_OS/Using_Gaia_in_Firefox
/ko/docs/B2G_OS/성능	/ko/docs/Archive/B2G_OS/%EC%84%B1%EB%8A%A5
/ko/docs/B2G_OS/앱_관리자_사용하기	/ko/docs/Archive/B2G_OS/%EC%95%B1_%EA%B4%80%EB%A6%AC%EC%9E%90_%EC%82%AC%EC%9A%A9%ED%95%98%EA%B8%B0
/ko/docs/CSS	/ko/docs/Web/CSS
/ko/docs/CSS/@font-face	/ko/docs/Web/CSS/@font-face
/ko/docs/CSS/Getting_Started	/ko/docs/Web/CSS/Getting_Started
/ko/docs/CSS/Getting_Started/Boxes	/ko/docs/Web/CSS/Getting_Started/Boxes
/ko/docs/CSS/Getting_Started/Cascading_and_inheritance	/ko/docs/Web/CSS/Getting_Started/Cascading_and_inheritance
/ko/docs/CSS/Getting_Started/Color	/ko/docs/Web/CSS/Getting_Started/Color
/ko/docs/CSS/Getting_Started/Content	/ko/docs/Web/CSS/Getting_Started/Content
/ko/docs/CSS/Getting_Started/How_CSS_works	/ko/docs/Web/CSS/Getting_Started/How_CSS_works
/ko/docs/CSS/Getting_Started/JavaScript	/ko/docs/Web/CSS/Getting_Started/JavaScript
/ko/docs/CSS/Getting_Started/Layout	/ko/docs/Web/CSS/Getting_Started/Layout
/ko/docs/CSS/Getting_Started/Lists	/ko/docs/Web/CSS/Getting_Started/Lists
/ko/docs/CSS/Getting_Started/Media	/ko/docs/Web/CSS/Getting_Started/Media
/ko/docs/CSS/Getting_Started/Readable_CSS	/ko/docs/Web/CSS/Getting_Started/Readable_CSS
/ko/docs/CSS/Getting_Started/SVG_graphics	/ko/docs/Web/CSS/Getting_Started/SVG_graphics
/ko/docs/CSS/Getting_Started/Selectors	/ko/docs/Web/CSS/Getting_Started/Selectors
/ko/docs/CSS/Getting_Started/Tables	/ko/docs/Web/CSS/Getting_Started/Tables
/ko/docs/CSS/Getting_Started/Text_styles	/ko/docs/Web/CSS/Getting_Started/Text_styles
/ko/docs/CSS/Getting_Started/What_is_CSS	/ko/docs/Web/CSS/Getting_Started/What_is_CSS
/ko/docs/CSS/Getting_Started/Why_use_CSS	/ko/docs/Web/CSS/Getting_Started/Why_use_CSS
/ko/docs/CSS/Getting_Started/XBL_bindings	/ko/docs/Web/CSS/Getting_Started/XBL_bindings
/ko/docs/CSS/Getting_Started/XML_data	/ko/docs/Web/CSS/Getting_Started/XML_data
/ko/docs/CSS/Getting_Started/XUL_user_interfaces	/ko/docs/Web/CSS/Getting_Started/XUL_user_interfaces
/ko/docs/CSS/Scaling_background_images	/ko/docs/Web/CSS/Scaling_background_images
/ko/docs/CSS/Understanding_z-index	/ko/docs/Web/CSS/Understanding_z-index
/ko/docs/CSS/Understanding_z-index-redirect-1	/ko/docs/CSS/Understanding_z-index
/ko/docs/CSS/Understanding_z-index/Adding_z-index	/ko/docs/Web/CSS/Understanding_z-index/Adding_z-index
/ko/docs/CSS/Understanding_z-index/Stacking_and_float	/ko/docs/Web/CSS/Understanding_z-index/Stacking_and_float
/ko/docs/CSS/Understanding_z-index/Stacking_and_float-redirect-1	/ko/docs/CSS/Understanding_z-index/Stacking_and_float
/ko/docs/CSS/Understanding_z-index/Stacking_context_example_1	/ko/docs/Web/CSS/Understanding_z-index/Stacking_context_example_1
/ko/docs/CSS/Understanding_z-index/Stacking_context_example_2	/ko/docs/Web/CSS/Understanding_z-index/Stacking_context_example_2
/ko/docs/CSS/Understanding_z-index/Stacking_context_example_2-redirect-1	/ko/docs/CSS/Understanding_z-index/Stacking_context_example_2
/ko/docs/CSS/Understanding_z-index/Stacking_context_example_3	/ko/docs/Web/CSS/Understanding_z-index/Stacking_context_example_3
/ko/docs/CSS/Understanding_z-index/Stacking_without_z-index	/ko/docs/Web/CSS/Understanding_z-index/Stacking_without_z-index
/ko/docs/CSS/Understanding_z-index/Stacking_without_z-index-redirect-1	/ko/docs/CSS/Understanding_z-index/Stacking_without_z-index
/ko/docs/CSS/Understanding_z-index/The_stacking_context	/ko/docs/Web/CSS/Understanding_z-index/The_stacking_context
/ko/docs/CSS/Using_CSS_animations	/ko/docs/Web/CSS/Using_CSS_animations
/ko/docs/CSS/Using_CSS_multiple_backgrounds	/ko/docs/Web/CSS/Using_CSS_multiple_backgrounds
/ko/docs/CSS/Using_CSS_transforms	/ko/docs/Web/CSS/Using_CSS_transforms
/ko/docs/CSS/Writing_Efficient_CSS	/ko/docs/Web/CSS/Writing_Efficient_CSS
/ko/docs/CSS/Writing_Efficient_CSS-redirect-1	/ko/docs/CSS/Writing_Efficient_CSS
/ko/docs/CSS/animation	/ko/docs/Web/CSS/animation
/ko/docs/CSS/background	/ko/docs/Web/CSS/background
/ko/docs/CSS/background-color	/ko/docs/Web/CSS/background-color
/ko/docs/CSS/background-image	/ko/docs/Web/CSS/background-image
/ko/docs/CSS/border-radius	/ko/docs/Web/CSS/border-radius
/ko/docs/CSS/box-shadow	/ko/docs/Web/CSS/box-shadow
/ko/docs/CSS/cursor	/ko/docs/Web/CSS/cursor
/ko/docs/CSS/cursor/Using_URL_values_for_the_cursor_property	/ko/docs/Web/CSS/cursor/Using_URL_values_for_the_cursor_property
/ko/docs/CSS/initial_value	/ko/docs/Web/CSS/initial_value
/ko/docs/CSS/linear-gradient	/ko/docs/Web/CSS/linear-gradient
/ko/docs/CSS/table-layout	/ko/docs/Web/CSS/table-layout
/ko/docs/CSS/text-shadow	/ko/docs/Web/CSS/text-shadow
/ko/docs/CSS/transform	/ko/docs/Web/CSS/transform
/ko/docs/CSS/z-index	/ko/docs/Web/CSS/z-index
/ko/docs/CSS/시작하기	/ko/docs/Web/CSS/%EC%8B%9C%EC%9E%91%ED%95%98%EA%B8%B0
/ko/docs/CSS/시작하기/CSS_동작_원리	/ko/docs/Web/CSS/%EC%8B%9C%EC%9E%91%ED%95%98%EA%B8%B0/CSS_%EB%8F%99%EC%9E%91_%EC%9B%90%EB%A6%AC
/ko/docs/CSS/시작하기/CSS란	/ko/docs/Web/CSS/%EC%8B%9C%EC%9E%91%ED%95%98%EA%B8%B0/CSS%EB%9E%80
/ko/docs/CSS/시작하기/내용물	/ko/docs/Web/CSS/%EC%8B%9C%EC%9E%91%ED%95%98%EA%B8%B0/%EB%82%B4%EC%9A%A9%EB%AC%BC
/ko/docs/CSS/시작하기/리스트	/ko/docs/Web/CSS/%EC%8B%9C%EC%9E%91%ED%95%98%EA%B8%B0/%EB%A6%AC%EC%8A%A4%ED%8A%B8
/ko/docs/CSS/시작하기/미디어	/ko/docs/Web/CSS/%EC%8B%9C%EC%9E%91%ED%95%98%EA%B8%B0/%EB%AF%B8%EB%94%94%EC%96%B4
/ko/docs/CSS/시작하기/배치	/ko/docs/Web/CSS/%EC%8B%9C%EC%9E%91%ED%95%98%EA%B8%B0/%EB%B0%B0%EC%B9%98
/ko/docs/CSS/시작하기/상자	/ko/docs/Web/CSS/%EC%8B%9C%EC%9E%91%ED%95%98%EA%B8%B0/%EC%83%81%EC%9E%90
/ko/docs/CSS/시작하기/색상	/ko/docs/Web/CSS/%EC%8B%9C%EC%9E%91%ED%95%98%EA%B8%B0/%EC%83%89%EC%83%81
/ko/docs/CSS/시작하기/설렉터	/ko/docs/Web/CSS/%EC%8B%9C%EC%9E%91%ED%95%98%EA%B8%B0/%EC%84%A4%EB%A0%89%ED%84%B0
/ko/docs/CSS/시작하기/알기_쉬운_CSS	/ko/docs/Web/CSS/%EC%8B%9C%EC%9E%91%ED%95%98%EA%B8%B0/%EC%95%8C%EA%B8%B0_%EC%89%AC%EC%9A%B4_CSS
/ko/docs/CSS/시작하기/왜_CSS를_사용하나	/ko/docs/Web/CSS/%EC%8B%9C%EC%9E%91%ED%95%98%EA%B8%B0/%EC%99%9C_CSS%EB%A5%BC_%EC%82%AC%EC%9A%A9%ED%95%98%EB%82%98
/ko/docs/CSS/시작하기/종속과_상속	/ko/docs/Web/CSS/%EC%8B%9C%EC%9E%91%ED%95%98%EA%B8%B0/%EC%A2%85%EC%86%8D%EA%B3%BC_%EC%83%81%EC%86%8D
/ko/docs/CSS/시작하기/테이블	/ko/docs/Web/CSS/%EC%8B%9C%EC%9E%91%ED%95%98%EA%B8%B0/%ED%85%8C%EC%9D%B4%EB%B8%94
/ko/docs/CSS/시작하기/텍스트_스타일	/ko/docs/Web/CSS/%EC%8B%9C%EC%9E%91%ED%95%98%EA%B8%B0/%ED%85%8D%EC%8A%A4%ED%8A%B8_%EC%8A%A4%ED%83%80%EC%9D%BC
/ko/docs/CSS:Getting_Started	/docs/ko/CSS/Getting_Started
/ko/docs/CSS:Getting_Started:Boxes	/docs/ko/CSS/Getting_Started/Boxes
/ko/docs/CSS:Getting_Started:Cascading_and_inheritance	/docs/ko/CSS/Getting_Started/Cascading_and_inheritance
/ko/docs/CSS:Getting_Started:Color	/docs/ko/CSS/Getting_Started/Color
/ko/docs/CSS:Getting_Started:Content	/docs/ko/CSS/Getting_Started/Content
/ko/docs/CSS:Getting_Started:How_CSS_works	/docs/ko/CSS/Getting_Started/How_CSS_works
/ko/docs/CSS:Getting_Started:JavaScript	/docs/ko/CSS/Getting_Started/JavaScript
/ko/docs/CSS:Getting_Started:Layout	/docs/ko/CSS/Getting_Started/Layout
/ko/docs/CSS:Getting_Started:Lists	/docs/ko/CSS/Getting_Started/Lists
/ko/docs/CSS:Getting_Started:Media	/docs/ko/CSS/Getting_Started/Media
/ko/docs/CSS:Getting_Started:Readable_CSS	/docs/ko/CSS/Getting_Started/Readable_CSS
/ko/docs/CSS:Getting_Started:SVG_graphics	/docs/ko/CSS/Getting_Started/SVG_graphics
/ko/docs/CSS:Getting_Started:Selectors	/docs/ko/CSS/Getting_Started/Selectors
/ko/docs/CSS:Getting_Started:Tables	/docs/ko/CSS/Getting_Started/Tables
/ko/docs/CSS:Getting_Started:Text_styles	/docs/ko/CSS/Getting_Started/Text_styles
/ko/docs/CSS:Getting_Started:What_is_CSS	/docs/ko/CSS/Getting_Started/What_is_CSS
/ko/docs/CSS:Getting_Started:Why_use_CSS	/docs/ko/CSS/Getting_Started/Why_use_CSS
/ko/docs/CSS:Getting_Started:XBL_bindings	/docs/ko/CSS/Getting_Started/XBL_bindings
/ko/docs/CSS:Getting_Started:XML_data	/docs/ko/CSS/Getting_Started/XML_data
/ko/docs/CSS:Getting_Started:XUL_user_interfaces	/docs/ko/CSS/Getting_Started/XUL_user_interfaces
/ko/docs/CSS:background	/docs/ko/CSS/background
/ko/docs/CSS:initial_value	/docs/ko/CSS/initial_value
/ko/docs/CSS_Reference	/ko/docs/Web/CSS/CSS_Reference
/ko/docs/CSS_Reference/Property_Template	/ko/docs/Web/CSS/CSS_Reference/Property_Template
/ko/docs/CSS_Reference:Property_Template	/docs/ko/CSS_Reference/Property_Template
/ko/docs/Canvas_tutorial:Basic_usage	/docs/ko/Canvas_tutorial/Basic_usage
/ko/docs/Canvas_tutorial:Drawing_shapes	/docs/ko/Canvas_tutorial/Drawing_shapes
/ko/docs/Canvas_tutorial:Transformations	/docs/ko/Canvas_tutorial/Transformations
/ko/docs/Code_snippets:Cookies	/docs/ko/Code_snippets/Cookies
/ko/docs/Code_snippets:Page_Loading	/docs/ko/Code_snippets/Page_Loading
/ko/docs/Code_snippets:Running_applications	/docs/ko/Code_snippets/Running_applications
/ko/docs/Code_snippets:Windows	/docs/ko/Code_snippets/Windows
/ko/docs/Code_snippets:XML	/docs/ko/Code_snippets/XML
/ko/docs/Core_JavaScript_1.5_Guide	/ko/docs/JavaScript/Guide/Obsolete_Pages/Core_JavaScript_1.5_Guide
/ko/docs/Core_JavaScript_1.5_Guide/About	/ko/docs/JavaScript/Guide/Obsolete_Pages/Core_JavaScript_1.5_Guide/About
/ko/docs/Core_JavaScript_1.5_Guide/Class-Based_vs._Prototype-Based_Languages	/ko/docs/JavaScript/Guide/Obsolete_Pages/Core_JavaScript_1.5_Guide/Class-Based_vs._Prototype-Based_Languages
/ko/docs/Core_JavaScript_1.5_Guide/Constants	/ko/docs/JavaScript/Guide/Obsolete_Pages/Core_JavaScript_1.5_Guide/Constants
/ko/docs/Core_JavaScript_1.5_Guide/Creating_New_Objects	/ko/docs/JavaScript/Guide/Obsolete_Pages/Core_JavaScript_1.5_Guide/Creating_New_Objects
/ko/docs/Core_JavaScript_1.5_Guide/Creating_New_Objects/Defining_Getters_and_Setters	/ko/docs/JavaScript/Guide/Obsolete_Pages/Core_JavaScript_1.5_Guide/Creating_New_Objects/Defining_Getters_and_Setters
/ko/docs/Core_JavaScript_1.5_Guide/Creating_New_Objects/Defining_Methods	/ko/docs/JavaScript/Guide/Obsolete_Pages/Core_JavaScript_1.5_Guide/Creating_New_Objects/Defining_Methods
/ko/docs/Core_JavaScript_1.5_Guide/Creating_New_Objects/Defining_Properties_for_an_Object_Type	/ko/docs/JavaScript/Guide/Obsolete_Pages/Core_JavaScript_1.5_Guide/Creating_New_Objects/Defining_Properties_for_an_Object_Type
/ko/docs/Core_JavaScript_1.5_Guide/Creating_New_Objects/Deleting_Properties	/ko/docs/JavaScript/Guide/Obsolete_Pages/Core_JavaScript_1.5_Guide/Creating_New_Objects/Deleting_Properties
/ko/docs/Core_JavaScript_1.5_Guide/Creating_New_Objects/Indexing_Object_Properties	/ko/docs/JavaScript/Guide/Obsolete_Pages/Core_JavaScript_1.5_Guide/Creating_New_Objects/Indexing_Object_Properties
/ko/docs/Core_JavaScript_1.5_Guide/Creating_New_Objects/Using_Object_Initializers	/ko/docs/JavaScript/Guide/Obsolete_Pages/Core_JavaScript_1.5_Guide/Creating_New_Objects/Using_Object_Initializers
/ko/docs/Core_JavaScript_1.5_Guide/Creating_New_Objects/Using_a_Constructor_Function	/ko/docs/JavaScript/Guide/Obsolete_Pages/Core_JavaScript_1.5_Guide/Creating_New_Objects/Using_a_Constructor_Function
/ko/docs/Core_JavaScript_1.5_Guide/Creating_New_Objects/Using_this_for_Object_References	/ko/docs/JavaScript/Guide/Obsolete_Pages/Core_JavaScript_1.5_Guide/Creating_New_Objects/Using_this_for_Object_References
/ko/docs/Core_JavaScript_1.5_Guide/Creating_a_Regular_Expression	/ko/docs/JavaScript/Guide/Obsolete_Pages/Core_JavaScript_1.5_Guide/Creating_a_Regular_Expression
/ko/docs/Core_JavaScript_1.5_Guide/Expressions	/ko/docs/JavaScript/Guide/Obsolete_Pages/Core_JavaScript_1.5_Guide/Expressions
/ko/docs/Core_JavaScript_1.5_Guide/JavaScript_Overview	/ko/docs/JavaScript/Guide/Obsolete_Pages/Core_JavaScript_1.5_Guide/JavaScript_Overview
/ko/docs/Core_JavaScript_1.5_Guide/Literals	/ko/docs/JavaScript/Guide/Obsolete_Pages/Core_JavaScript_1.5_Guide/Literals
/ko/docs/Core_JavaScript_1.5_Guide/Objects_and_Properties	/ko/docs/JavaScript/Guide/Obsolete_Pages/Core_JavaScript_1.5_Guide/Objects_and_Properties
/ko/docs/Core_JavaScript_1.5_Guide/Operators	/ko/docs/JavaScript/Guide/Obsolete_Pages/Core_JavaScript_1.5_Guide/Operators
/ko/docs/Core_JavaScript_1.5_Guide/Operators/Arithmetic_Operators	/ko/docs/JavaScript/Guide/Obsolete_Pages/Core_JavaScript_1.5_Guide/Operators/Arithmetic_Operators
/ko/docs/Core_JavaScript_1.5_Guide/Operators/Assignment_Operators	/ko/docs/JavaScript/Guide/Obsolete_Pages/Core_JavaScript_1.5_Guide/Operators/Assignment_Operators
/ko/docs/Core_JavaScript_1.5_Guide/Operators/Bitwise_Operators	/ko/docs/JavaScript/Guide/Obsolete_Pages/Core_JavaScript_1.5_Guide/Operators/Bitwise_Operators
/ko/docs/Core_JavaScript_1.5_Guide/Operators/Comparison_Operators	/ko/docs/JavaScript/Guide/Obsolete_Pages/Core_JavaScript_1.5_Guide/Operators/Comparison_Operators
/ko/docs/Core_JavaScript_1.5_Guide/Operators/Logical_Operators	/ko/docs/JavaScript/Guide/Obsolete_Pages/Core_JavaScript_1.5_Guide/Operators/Logical_Operators
/ko/docs/Core_JavaScript_1.5_Guide/Operators/Special_Operators	/ko/docs/JavaScript/Guide/Obsolete_Pages/Core_JavaScript_1.5_Guide/Operators/Special_Operators
/ko/docs/Core_JavaScript_1.5_Guide/Operators/String_Operators	/ko/docs/JavaScript/Guide/Obsolete_Pages/Core_JavaScript_1.5_Guide/Operators/String_Operators
/ko/docs/Core_JavaScript_1.5_Guide/Predefined_Core_Objects	/ko/docs/JavaScript/Guide/Obsolete_Pages/Core_JavaScript_1.5_Guide/Predefined_Core_Objects
/ko/docs/Core_JavaScript_1.5_Guide/Predefined_Core_Objects/Array_Object	/ko/docs/JavaScript/Guide/Obsolete_Pages/Core_JavaScript_1.5_Guide/Predefined_Core_Objects/Array_Object
/ko/docs/Core_JavaScript_1.5_Guide/Unicode	/ko/docs/JavaScript/Guide/Obsolete_Pages/Core_JavaScript_1.5_Guide/Unicode
/ko/docs/Core_JavaScript_1.5_Guide/Values	/ko/docs/JavaScript/Guide/Obsolete_Pages/Core_JavaScript_1.5_Guide/Values
/ko/docs/Core_JavaScript_1.5_Guide/Variables	/ko/docs/JavaScript/Guide/Obsolete_Pages/Core_JavaScript_1.5_Guide/Variables
/ko/docs/Core_JavaScript_1.5_Guide/Writing_a_Regular_Expression_Pattern	/ko/docs/JavaScript/Guide/Obsolete_Pages/Core_JavaScript_1.5_Guide/Writing_a_Regular_Expression_Pattern
/ko/docs/Core_JavaScript_1.5_Guide:About	/docs/ko/Core_JavaScript_1.5_Guide/About
/ko/docs/Core_JavaScript_1.5_Guide:About:Core_Language_Features	/docs/ko/Core_JavaScript_1.5_Guide/About/Core_Language_Features
/ko/docs/Core_JavaScript_1.5_Guide:Constants	/docs/ko/Core_JavaScript_1.5_Guide/Constants
/ko/docs/Core_JavaScript_1.5_Guide:Creating_New_Objects:Defining_Getters_and_Setters	/docs/ko/Core_JavaScript_1.5_Guide/Creating_New_Objects/Defining_Getters_and_Setters
/ko/docs/Core_JavaScript_1.5_Guide:Creating_New_Objects:Defining_Methods	/docs/ko/Core_JavaScript_1.5_Guide/Creating_New_Objects/Defining_Methods
/ko/docs/Core_JavaScript_1.5_Guide:Creating_New_Objects:Defining_Properties_for_an_Object_Type	/docs/ko/Core_JavaScript_1.5_Guide/Creating_New_Objects/Defining_Properties_for_an_Object_Type
/ko/docs/Core_JavaScript_1.5_Guide:Creating_New_Objects:Deleting_Properties	/docs/ko/Core_JavaScript_1.5_Guide/Creating_New_Objects/Deleting_Properties
/ko/docs/Core_JavaScript_1.5_Guide:Creating_New_Objects:Indexing_Object_Properties	/docs/ko/Core_JavaScript_1.5_Guide/Creating_New_Objects/Indexing_Object_Properties
/ko/docs/Core_JavaScript_1.5_Guide:Creating_New_Objects:Using_a_Constructor_Function	/docs/ko/Core_JavaScript_1.5_Guide/Creating_New_Objects/Using_a_Constructor_Function
/ko/docs/Core_JavaScript_1.5_Guide:Creating_New_Objects:Using_this_for_Object_References	/docs/ko/Core_JavaScript_1.5_Guide/Creating_New_Objects/Using_this_for_Object_References
/ko/docs/Core_JavaScript_1.5_Guide:Creating_a_Regular_Expression	/docs/ko/Core_JavaScript_1.5_Guide/Creating_a_Regular_Expression
/ko/docs/Core_JavaScript_1.5_Guide:Expressions	/docs/ko/Core_JavaScript_1.5_Guide/Expressions
/ko/docs/Core_JavaScript_1.5_Guide:Expressions_and_Operators	/docs/ko/Core_JavaScript_1.5_Guide/Expressions_and_Operators
/ko/docs/Core_JavaScript_1.5_Guide:JavaScript_Overview	/docs/ko/Core_JavaScript_1.5_Guide/JavaScript_Overview
/ko/docs/Core_JavaScript_1.5_Guide:Literals	/docs/ko/Core_JavaScript_1.5_Guide/Literals
/ko/docs/Core_JavaScript_1.5_Guide:Objects_and_Properties	/docs/ko/Core_JavaScript_1.5_Guide/Objects_and_Properties
/ko/docs/Core_JavaScript_1.5_Guide:Operators	/docs/ko/Core_JavaScript_1.5_Guide/Operators
/ko/docs/Core_JavaScript_1.5_Guide:Operators:Arithmetic_Operators	/docs/ko/Core_JavaScript_1.5_Guide/Operators/Arithmetic_Operators
/ko/docs/Core_JavaScript_1.5_Guide:Operators:Assignment_Operators	/docs/ko/Core_JavaScript_1.5_Guide/Operators/Assignment_Operators
/ko/docs/Core_JavaScript_1.5_Guide:Operators:Bitwise_Operators	/docs/ko/Core_JavaScript_1.5_Guide/Operators/Bitwise_Operators
/ko/docs/Core_JavaScript_1.5_Guide:Operators:Comparison_Operators	/docs/ko/Core_JavaScript_1.5_Guide/Operators/Comparison_Operators
/ko/docs/Core_JavaScript_1.5_Guide:Operators:Logical_Operators	/docs/ko/Core_JavaScript_1.5_Guide/Operators/Logical_Operators
/ko/docs/Core_JavaScript_1.5_Guide:Operators:Special_Operators	/docs/ko/Core_JavaScript_1.5_Guide/Operators/Special_Operators
/ko/docs/Core_JavaScript_1.5_Guide:Operators:String_Operators	/docs/ko/Core_JavaScript_1.5_Guide/Operators/String_Operators
/ko/docs/Core_JavaScript_1.5_Guide:Predefined_Core_Objects	/docs/ko/Core_JavaScript_1.5_Guide/Predefined_Core_Objects
/ko/docs/Core_JavaScript_1.5_Guide:Predefined_Core_Objects:Array_Object	/docs/ko/Core_JavaScript_1.5_Guide/Predefined_Core_Objects/Array_Object
/ko/docs/Core_JavaScript_1.5_Guide:Unicode	/docs/ko/Core_JavaScript_1.5_Guide/Unicode
/ko/docs/Core_JavaScript_1.5_Guide:Values	/docs/ko/Core_JavaScript_1.5_Guide/Values
/ko/docs/Core_JavaScript_1.5_Guide:Variables	/docs/ko/Core_JavaScript_1.5_Guide/Variables
/ko/docs/Core_JavaScript_1.5_Guide:Writing_a_Regular_Expression_Pattern	/docs/ko/Core_JavaScript_1.5_Guide/Writing_a_Regular_Expression_Pattern
/ko/docs/Core_JavaScript_1.5_Guide:_Creating_New_Objects:Using_Object_Initializers	/docs/ko/Core_JavaScript_1.5_Guide/Creating_New_Objects/Using_Object_Initializers
/ko/docs/Core_JavaScript_1.5_Reference	/ko/docs/JavaScript/Reference
/ko/docs/Core_JavaScript_1.5_Reference/About	/ko/docs/JavaScript/Reference/About
/ko/docs/Core_JavaScript_1.5_Reference/About/Formatting_Conventions	/ko/docs/JavaScript/Reference/About/Formatting_Conventions
/ko/docs/Core_JavaScript_1.5_Reference/Global_Functions	/ko/docs/JavaScript/Reference/Global_Functions
/ko/docs/Core_JavaScript_1.5_Reference/Global_Objects	/ko/docs/JavaScript/Reference/Global_Objects
/ko/docs/Core_JavaScript_1.5_Reference/Global_Objects/Array	/ko/docs/JavaScript/Reference/Global_Objects/Array
/ko/docs/Core_JavaScript_1.5_Reference/Global_Objects/Boolean	/ko/docs/JavaScript/Reference/Global_Objects/Boolean
/ko/docs/Core_JavaScript_1.5_Reference/Global_Objects/Date	/ko/docs/JavaScript/Reference/Global_Objects/Date
/ko/docs/Core_JavaScript_1.5_Reference/Global_Objects/Error	/ko/docs/JavaScript/Reference/Global_Objects/Error
/ko/docs/Core_JavaScript_1.5_Reference/Global_Objects/Function	/ko/docs/JavaScript/Reference/Global_Objects/Function
/ko/docs/Core_JavaScript_1.5_Reference/Global_Objects/Function/call	/ko/docs/JavaScript/Reference/Global_Objects/Function/call
/ko/docs/Core_JavaScript_1.5_Reference/Global_Objects/Function/prototype	/ko/docs/JavaScript/Reference/Global_Objects/Function/prototype
/ko/docs/Core_JavaScript_1.5_Reference/Global_Objects/NaN	/ko/docs/JavaScript/Reference/Global_Objects/NaN
/ko/docs/Core_JavaScript_1.5_Reference/Global_Objects/Object	/ko/docs/JavaScript/Reference/Global_Objects/Object
/ko/docs/Core_JavaScript_1.5_Reference/Global_Objects/String	/ko/docs/JavaScript/Reference/Global_Objects/String
/ko/docs/Core_JavaScript_1.5_Reference/Global_Objects/String/prototype	/ko/docs/JavaScript/Reference/Global_Objects/String/prototype
/ko/docs/Core_JavaScript_1.5_Reference/Global_Properties	/ko/docs/JavaScript/Reference/Global_Properties
/ko/docs/Core_JavaScript_1.5_Reference/Global_Properties/NaN	/ko/docs/JavaScript/Reference/Global_Objects/NaN
/ko/docs/Core_JavaScript_1.5_Reference/LiveConnect	/ko/docs/JavaScript/Reference/LiveConnect
/ko/docs/Core_JavaScript_1.5_Reference/Objects	/ko/docs/JavaScript/Reference/Objects
/ko/docs/Core_JavaScript_1.5_Reference/Objects/Function	/ko/docs/JavaScript/Reference/Objects/Function
/ko/docs/Core_JavaScript_1.5_Reference/Operators	/ko/docs/JavaScript/Reference/Operators
/ko/docs/Core_JavaScript_1.5_Reference/Operators/Bitwise_Operators	/ko/docs/JavaScript/Reference/Operators/Bitwise_Operators
/ko/docs/Core_JavaScript_1.5_Reference/Operators/Special_Operators	/ko/docs/JavaScript/Reference/Operators/Special_Operators
/ko/docs/Core_JavaScript_1.5_Reference/Operators/Special_Operators/this_Operator	/ko/docs/Core_JavaScript_1.5_Reference/Operators/this
/ko/docs/Core_JavaScript_1.5_Reference/Operators/this	/ko/docs/JavaScript/Reference/Operators/this
/ko/docs/Core_JavaScript_1.5_Reference/Operators/void	/ko/docs/JavaScript/Reference/Operators/void
/ko/docs/Core_JavaScript_1.5_Reference/Reserved_Words	/ko/docs/JavaScript/Reference/Reserved_Words
/ko/docs/Core_JavaScript_1.5_Reference/Statements	/ko/docs/JavaScript/Reference/Statements
/ko/docs/Core_JavaScript_1.5_Reference/Statements/for...in	/ko/docs/JavaScript/Reference/Statements/for...in
/ko/docs/Core_JavaScript_1.5_Reference:About	/docs/ko/Core_JavaScript_1.5_Reference/About
/ko/docs/Core_JavaScript_1.5_Reference:About:Formatting_Conventions	/docs/ko/Core_JavaScript_1.5_Reference/About/Formatting_Conventions
/ko/docs/Core_JavaScript_1.5_Reference:Global_Functions	/docs/ko/Core_JavaScript_1.5_Reference/Global_Functions
/ko/docs/Core_JavaScript_1.5_Reference:Global_Objects	/docs/ko/Core_JavaScript_1.5_Reference/Global_Objects
/ko/docs/Core_JavaScript_1.5_Reference:Global_Objects:Array	/docs/ko/Core_JavaScript_1.5_Reference/Global_Objects/Array
/ko/docs/Core_JavaScript_1.5_Reference:Global_Objects:Date	/docs/ko/Core_JavaScript_1.5_Reference/Global_Objects/Date
/ko/docs/Core_JavaScript_1.5_Reference:Global_Objects:Function	/docs/ko/Core_JavaScript_1.5_Reference/Global_Objects/Function
/ko/docs/Core_JavaScript_1.5_Reference:Global_Objects:Function:prototype	/docs/ko/Core_JavaScript_1.5_Reference/Global_Objects/Function/prototype
/ko/docs/Core_JavaScript_1.5_Reference:Global_Properties	/docs/ko/Core_JavaScript_1.5_Reference/Global_Properties
/ko/docs/Core_JavaScript_1.5_Reference:LiveConnect	/docs/ko/Core_JavaScript_1.5_Reference/LiveConnect
/ko/docs/Core_JavaScript_1.5_Reference:Objects:Function	/docs/ko/Core_JavaScript_1.5_Reference/Objects/Function
/ko/docs/Core_JavaScript_1.5_Reference:Operators:Special_Operators:this_Operator	/docs/ko/Core_JavaScript_1.5_Reference/Operators/Special_Operators/this_Operator
/ko/docs/Core_JavaScript_1.5_Reference:Reserved_Words	/docs/ko/Core_JavaScript_1.5_Reference/Reserved_Words
/ko/docs/Creating_XPCOM_Components:An_Overview_of_XPCOM	/docs/ko/Creating_XPCOM_Components/An_Overview_of_XPCOM
/ko/docs/Creating_XPCOM_Components:Preface	/docs/ko/Creating_XPCOM_Components/Preface
/ko/docs/Creating_a_Skin_for_Firefox:Getting_Started	/docs/ko/Creating_a_Skin_for_Firefox/Getting_Started
/ko/docs/Creating_a_Skin_for_Firefox:UUID	/docs/ko/Creating_a_Skin_for_Firefox/UUID
/ko/docs/Creating_a_Skin_for_Firefox:contents.rdf	/docs/ko/Creating_a_Skin_for_Firefox/contents.rdf
/ko/docs/Creating_a_Skin_for_Firefox:install.rdf	/docs/ko/Creating_a_Skin_for_Firefox/install.rdf
/ko/docs/DOM/Notification.permission	/ko/docs/Web/API/Notification.permission
/ko/docs/DOM/document	/ko/docs/Web/API/Document
/ko/docs/DOM/document.activeElement	/ko/docs/Web/API/Document/activeElement
/ko/docs/DOM/document.alinkColor	/ko/docs/Web/API/Document/alinkColor
/ko/docs/DOM/document.anchors	/ko/docs/Web/API/Document/anchors
/ko/docs/DOM/document.applets	/ko/docs/Web/API/Document/applets
/ko/docs/DOM/document.body	/ko/docs/Web/API/Document/body
/ko/docs/DOM/document.createElement	/ko/docs/Web/API/Document/createElement
/ko/docs/DOM/document.createTextNode	/ko/docs/Web/API/Document/createTextNode
/ko/docs/DOM/document.getElementById	/ko/docs/Web/API/Document/getElementById
/ko/docs/DOM/document.hasFocus	/ko/docs/Web/API/Document/hasFocus
/ko/docs/DOM/element	/ko/docs/Web/API/element
/ko/docs/DOM/element.attributes	/ko/docs/Web/API/Element/attributes
/ko/docs/DOM/element.childNodes	/ko/docs/Web/API/Element/childNodes
/ko/docs/DOM/element.firstChild	/ko/docs/Web/API/Element/firstChild
/ko/docs/DOM/element.lastChild	/ko/docs/Web/API/Node/lastChild
/ko/docs/DOM/element.length	/ko/docs/Web/API/NodeList/length
/ko/docs/DOM/element.scrollIntoView	/ko/docs/Web/API/Element/scrollIntoView
/ko/docs/DOM/element.style	/ko/docs/Web/API/HTMLElement/style
/ko/docs/DOM/element.tabIndex	/ko/docs/Web/API/HTMLElement/tabIndex
/ko/docs/DOM/event	/ko/docs/Web/API/Event
/ko/docs/DOM/event.cancelable	/ko/docs/Web/API/Event/cancelable
/ko/docs/DOM/event.preventDefault	/ko/docs/Web/API/Event/preventDefault
/ko/docs/DOM/form	/ko/docs/Web/API/HTMLFormElement
/ko/docs/DOM/range	/ko/docs/Web/API/Range
/ko/docs/DOM/selection	/ko/docs/Web/API/Selection
/ko/docs/DOM/table	/ko/docs/Web/API/HTMLTableElement
/ko/docs/DOM/table.width	/ko/docs/Web/API/HTMLTableElement/width
/ko/docs/DOM/window	/ko/docs/Web/API/Window
/ko/docs/DOM/window.getComputedStyle	/ko/docs/Web/API/Window/getComputedStyle
/ko/docs/DOM/window.navigator.geolocation.getCurrentPosition	/ko/docs/Web/API/Geolocation/getCurrentPosition
/ko/docs/DOM/window.navigator.registerProtocolHandler	/ko/docs/Web/API/Navigator/registerProtocolHandler
/ko/docs/DOM:WRONG_DOCUMENT_ERR_note	/docs/ko/DOM/WRONG_DOCUMENT_ERR_note
/ko/docs/DOM:Whitespace_template	/docs/ko/DOM/Whitespace_template
/ko/docs/DOM:document	/docs/ko/DOM/document
/ko/docs/DOM:document.activeElement	/docs/ko/DOM/document.activeElement
/ko/docs/DOM:document.alinkColor	/docs/ko/DOM/document.alinkColor
/ko/docs/DOM:document.anchors	/docs/ko/DOM/document.anchors
/ko/docs/DOM:document.applets	/docs/ko/DOM/document.applets
/ko/docs/DOM:document.body	/docs/ko/DOM/document.body
/ko/docs/DOM:document.createElement	/docs/ko/DOM/document.createElement
/ko/docs/DOM:document.createTextNode	/docs/ko/DOM/document.createTextNode
/ko/docs/DOM:document.getElementById	/docs/ko/DOM/document.getElementById
/ko/docs/DOM:document.hasFocus	/docs/ko/DOM/document.hasFocus
/ko/docs/DOM:element	/docs/ko/DOM/element
/ko/docs/DOM:element.attributes	/docs/ko/DOM/element.attributes
/ko/docs/DOM:element.childNodes	/docs/ko/DOM/element.childNodes
/ko/docs/DOM:element.firstChild	/docs/ko/DOM/element.firstChild
/ko/docs/DOM:element.lastChild	/docs/ko/DOM/element.lastChild
/ko/docs/DOM:element.length	/docs/ko/DOM/element.length
/ko/docs/DOM:element.style	/docs/ko/DOM/element.style
/ko/docs/DOM:element.tabIndex	/docs/ko/DOM/element.tabIndex
/ko/docs/DOM:event	/docs/ko/DOM/event
/ko/docs/DOM:form	/docs/ko/DOM/form
/ko/docs/DOM:range	/docs/ko/DOM/range
/ko/docs/DOM:selection	/docs/ko/DOM/selection
/ko/docs/DOM:table	/docs/ko/DOM/table
/ko/docs/DOM:table.width	/docs/ko/DOM/table.width
/ko/docs/DOM:window	/docs/ko/DOM/window
/ko/docs/DOM:window.navigator.registerProtocolHandler	/docs/ko/DOM/window.navigator.registerProtocolHandler
/ko/docs/Dialogs_in_XULRunner	/ko/docs/Archive/Mozilla/XULRunner/Dialogs_in_XULRunner
/ko/docs/Drawing_Graphics_with_Canvas	/ko/docs/Web/HTML/Canvas/Tutorial
/ko/docs/ECMAScript	/ko/docs/Web/JavaScript
/ko/docs/EXSLT	/ko/docs/Web/EXSLT
/ko/docs/Extension_Versioning,_Update_and_Compatibility	/ko/docs/Archive/Add-ons/Extension_Versioning,_Update_and_Compatibility
/ko/docs/Extensions:Community	/docs/ko/Extensions/Community
/ko/docs/Firefox_1.5	/docs/ko/Firefox_1.5_for_developers
/ko/docs/Firefox_2	/docs/ko/Firefox_2_for_developers
/ko/docs/Firefox_3.1_for_developers	/ko/docs/Firefox_3.5_for_developers
/ko/docs/Firefox_3_for_developers	/ko/docs/Mozilla/Firefox/Releases/3
/ko/docs/Focus_management_in_HTML	/ko/docs/HTML/Focus_management_in_HTML
/ko/docs/Gecko_DOM_Reference	/ko/docs/Web/API/Document_Object_Model
/ko/docs/Gecko_DOM_Reference/Examples	/ko/docs/Web/API/Document_Object_Model/Examples
/ko/docs/Gecko_DOM_Reference/Introduction	/ko/docs/Web/API/Document_Object_Model/Introduction
/ko/docs/Gecko_DOM_Reference/Locating_DOM_elements_using_selectors	/ko/docs/Web/API/Document_Object_Model/Locating_DOM_elements_using_selectors
/ko/docs/Gecko_DOM_Reference/Preface	/ko/docs/Web/API/Document_Object_Model/Preface
/ko/docs/Gecko_DOM_Reference/소개	/ko/docs/Web/API/Document_Object_Model/%EC%86%8C%EA%B0%9C
/ko/docs/Gecko_DOM_Reference:Examples	/docs/ko/Gecko_DOM_Reference/Examples
/ko/docs/Gecko_DOM_Reference:Introduction	/docs/ko/Gecko_DOM_Reference/Introduction
/ko/docs/Gecko_DOM_Reference:Preface	/docs/ko/Gecko_DOM_Reference/Preface
/ko/docs/Gecko_DOM_레퍼런스	/docs/ko/Gecko_DOM_Reference
/ko/docs/Getting_started_with_XULRunner	/ko/docs/Archive/Mozilla/XULRunner/Getting_started_with_XULRunner
/ko/docs/HTML	/ko/docs/Web/HTML
/ko/docs/HTML/Block-level_elements	/ko/docs/Web/HTML/Block-level_elements
/ko/docs/HTML/Canvas	/ko/docs/Web/HTML/Canvas
/ko/docs/HTML/Element	/ko/docs/Web/HTML/Element
/ko/docs/HTML/Element/Video	/ko/docs/Web/HTML/Element/Video
/ko/docs/HTML/Element/a	/ko/docs/Web/HTML/Element/a
/ko/docs/HTML/Focus_management_in_HTML	/ko/docs/Web/HTML/Focus_management_in_HTML
/ko/docs/HTML/HTML5	/ko/docs/Web/HTML/HTML5
/ko/docs/HTML/HTML5/HTML5_element_list	/ko/docs/Web/HTML/HTML5/HTML5_element_list
/ko/docs/HTML/HTML5/Introduction_to_HTML5	/ko/docs/Web/HTML/HTML5/Introduction_to_HTML5
/ko/docs/HTML/HTML에서_폼	/ko/docs/Web/HTML/HTML%EC%97%90%EC%84%9C_%ED%8F%BC
/ko/docs/HTML/Inline_elements	/ko/docs/Web/HTML/Inline_elements
/ko/docs/HTML/Introduction	/ko/docs/Web/HTML/Introduction
/ko/docs/HTML/Using_the_application_cache	/ko/docs/Web/HTML/Using_the_application_cache
/ko/docs/HTML:Canvas	/docs/ko/HTML/Canvas
/ko/docs/HTML:Element	/docs/ko/HTML/Element
/ko/docs/HTML:Element:a	/docs/ko/HTML/Element/a
/ko/docs/HTML:Inline_elements	/docs/ko/HTML/Inline_elements
/ko/docs/Help:Wiki_Markup_Reference	/docs/Project:ko/Wiki_Markup_Reference
/ko/docs/Interfaces	/ko/docs/Mozilla/Tech/XPCOM/Reference/Interface
/ko/docs/Interfaces/About_Scriptable_Interfaces	/ko/docs/Mozilla/Tech/XPCOM/Reference/Interface/About_Scriptable_Interfaces
/ko/docs/Interfaces:About_Scriptable_Interfaces	/docs/ko/Interfaces/About_Scriptable_Interfaces
/ko/docs/Issues_Arising_From_Arbitrary-Element_hover	/ko/docs/Archive/Web_Standards/Issues_Arising_From_Arbitrary-Element_hover
/ko/docs/JSAPI_Reference:Alphabetical_List	/docs/ko/JSAPI_Reference/Alphabetical_List
/ko/docs/JavaScript	/ko/docs/Web/JavaScript
/ko/docs/JavaScript/Data_structures	/ko/docs/Web/JavaScript/Data_structures
/ko/docs/JavaScript/Guide	/ko/docs/Web/JavaScript/Guide
/ko/docs/JavaScript/Guide/About	/ko/docs/Web/JavaScript/Guide/About
/ko/docs/JavaScript/Guide/Closures	/ko/docs/Web/JavaScript/Guide/Closures
/ko/docs/JavaScript/Guide/Inheritance_and_the_prototype_chain	/ko/docs/Web/JavaScript/Guide/Inheritance_and_the_prototype_chain
/ko/docs/JavaScript/Guide/Obsolete_Pages	/ko/docs/Web/JavaScript/Guide/Obsolete_Pages
/ko/docs/JavaScript/Guide/Obsolete_Pages/Core_JavaScript_1.5_Guide	/ko/docs/Web/JavaScript/Guide/Obsolete_Pages/Core_JavaScript_1.5_Guide
/ko/docs/JavaScript/Guide/Obsolete_Pages/Core_JavaScript_1.5_Guide/About	/ko/docs/Web/JavaScript/Guide/Obsolete_Pages/Core_JavaScript_1.5_Guide/About
/ko/docs/JavaScript/Guide/Obsolete_Pages/Core_JavaScript_1.5_Guide/Class-Based_vs._Prototype-Based_Languages	/ko/docs/Web/JavaScript/Guide/Obsolete_Pages/Core_JavaScript_1.5_Guide/Class-Based_vs._Prototype-Based_Languages
/ko/docs/JavaScript/Guide/Obsolete_Pages/Core_JavaScript_1.5_Guide/Constants	/ko/docs/Web/JavaScript/Guide/Obsolete_Pages/Core_JavaScript_1.5_Guide/Constants
/ko/docs/JavaScript/Guide/Obsolete_Pages/Core_JavaScript_1.5_Guide/Creating_New_Objects	/ko/docs/Web/JavaScript/Guide/Obsolete_Pages/Core_JavaScript_1.5_Guide/Creating_New_Objects
/ko/docs/JavaScript/Guide/Obsolete_Pages/Core_JavaScript_1.5_Guide/Creating_New_Objects/Defining_Getters_and_Setters	/ko/docs/Web/JavaScript/Guide/Obsolete_Pages/Core_JavaScript_1.5_Guide/Creating_New_Objects/Defining_Getters_and_Setters
/ko/docs/JavaScript/Guide/Obsolete_Pages/Core_JavaScript_1.5_Guide/Creating_New_Objects/Defining_Methods	/ko/docs/Web/JavaScript/Guide/Obsolete_Pages/Core_JavaScript_1.5_Guide/Creating_New_Objects/Defining_Methods
/ko/docs/JavaScript/Guide/Obsolete_Pages/Core_JavaScript_1.5_Guide/Creating_New_Objects/Defining_Properties_for_an_Object_Type	/ko/docs/Web/JavaScript/Guide/Obsolete_Pages/Core_JavaScript_1.5_Guide/Creating_New_Objects/Defining_Properties_for_an_Object_Type
/ko/docs/JavaScript/Guide/Obsolete_Pages/Core_JavaScript_1.5_Guide/Creating_New_Objects/Deleting_Properties	/ko/docs/Web/JavaScript/Guide/Obsolete_Pages/Core_JavaScript_1.5_Guide/Creating_New_Objects/Deleting_Properties
/ko/docs/JavaScript/Guide/Obsolete_Pages/Core_JavaScript_1.5_Guide/Creating_New_Objects/Indexing_Object_Properties	/ko/docs/Web/JavaScript/Guide/Obsolete_Pages/Core_JavaScript_1.5_Guide/Creating_New_Objects/Indexing_Object_Properties
/ko/docs/JavaScript/Guide/Obsolete_Pages/Core_JavaScript_1.5_Guide/Creating_New_Objects/Using_Object_Initializers	/ko/docs/Web/JavaScript/Guide/Obsolete_Pages/Core_JavaScript_1.5_Guide/Creating_New_Objects/Using_Object_Initializers
/ko/docs/JavaScript/Guide/Obsolete_Pages/Core_JavaScript_1.5_Guide/Creating_New_Objects/Using_a_Constructor_Function	/ko/docs/Web/JavaScript/Guide/Obsolete_Pages/Core_JavaScript_1.5_Guide/Creating_New_Objects/Using_a_Constructor_Function
/ko/docs/JavaScript/Guide/Obsolete_Pages/Core_JavaScript_1.5_Guide/Creating_New_Objects/Using_this_for_Object_References	/ko/docs/Web/JavaScript/Guide/Obsolete_Pages/Core_JavaScript_1.5_Guide/Creating_New_Objects/Using_this_for_Object_References
/ko/docs/JavaScript/Guide/Obsolete_Pages/Core_JavaScript_1.5_Guide/Creating_a_Regular_Expression	/ko/docs/Web/JavaScript/Guide/Obsolete_Pages/Core_JavaScript_1.5_Guide/Creating_a_Regular_Expression
/ko/docs/JavaScript/Guide/Obsolete_Pages/Core_JavaScript_1.5_Guide/Expressions	/ko/docs/Web/JavaScript/Guide/Obsolete_Pages/Core_JavaScript_1.5_Guide/Expressions
/ko/docs/JavaScript/Guide/Obsolete_Pages/Core_JavaScript_1.5_Guide/JavaScript_Overview	/ko/docs/Web/JavaScript/Guide/Obsolete_Pages/Core_JavaScript_1.5_Guide/JavaScript_Overview
/ko/docs/JavaScript/Guide/Obsolete_Pages/Core_JavaScript_1.5_Guide/Literals	/ko/docs/Web/JavaScript/Guide/Obsolete_Pages/Core_JavaScript_1.5_Guide/Literals
/ko/docs/JavaScript/Guide/Obsolete_Pages/Core_JavaScript_1.5_Guide/Objects_and_Properties	/ko/docs/Web/JavaScript/Guide/Obsolete_Pages/Core_JavaScript_1.5_Guide/Objects_and_Properties
/ko/docs/JavaScript/Guide/Obsolete_Pages/Core_JavaScript_1.5_Guide/Operators	/ko/docs/Web/JavaScript/Guide/Obsolete_Pages/Core_JavaScript_1.5_Guide/Operators
/ko/docs/JavaScript/Guide/Obsolete_Pages/Core_JavaScript_1.5_Guide/Operators/Arithmetic_Operators	/ko/docs/Web/JavaScript/Guide/Obsolete_Pages/Core_JavaScript_1.5_Guide/Operators/Arithmetic_Operators
/ko/docs/JavaScript/Guide/Obsolete_Pages/Core_JavaScript_1.5_Guide/Operators/Assignment_Operators	/ko/docs/Web/JavaScript/Guide/Obsolete_Pages/Core_JavaScript_1.5_Guide/Operators/Assignment_Operators
/ko/docs/JavaScript/Guide/Obsolete_Pages/Core_JavaScript_1.5_Guide/Operators/Bitwise_Operators	/ko/docs/Web/JavaScript/Guide/Obsolete_Pages/Core_JavaScript_1.5_Guide/Operators/Bitwise_Operators
/ko/docs/JavaScript/Guide/Obsolete_Pages/Core_JavaScript_1.5_Guide/Operators/Comparison_Operators	/ko/docs/Web/JavaScript/Guide/Obsolete_Pages/Core_JavaScript_1.5_Guide/Operators/Comparison_Operators
/ko/docs/JavaScript/Guide/Obsolete_Pages/Core_JavaScript_1.5_Guide/Operators/Logical_Operators	/ko/docs/Web/JavaScript/Guide/Obsolete_Pages/Core_JavaScript_1.5_Guide/Operators/Logical_Operators
/ko/docs/JavaScript/Guide/Obsolete_Pages/Core_JavaScript_1.5_Guide/Operators/Special_Operators	/ko/docs/Web/JavaScript/Guide/Obsolete_Pages/Core_JavaScript_1.5_Guide/Operators/Special_Operators
/ko/docs/JavaScript/Guide/Obsolete_Pages/Core_JavaScript_1.5_Guide/Operators/String_Operators	/ko/docs/Web/JavaScript/Guide/Obsolete_Pages/Core_JavaScript_1.5_Guide/Operators/String_Operators
/ko/docs/JavaScript/Guide/Obsolete_Pages/Core_JavaScript_1.5_Guide/Predefined_Core_Objects	/ko/docs/Web/JavaScript/Guide/Obsolete_Pages/Core_JavaScript_1.5_Guide/Predefined_Core_Objects
/ko/docs/JavaScript/Guide/Obsolete_Pages/Core_JavaScript_1.5_Guide/Predefined_Core_Objects/Array_Object	/ko/docs/Web/JavaScript/Guide/Obsolete_Pages/Core_JavaScript_1.5_Guide/Predefined_Core_Objects/Array_Object
/ko/docs/JavaScript/Guide/Obsolete_Pages/Core_JavaScript_1.5_Guide/Unicode	/ko/docs/Web/JavaScript/Guide/Obsolete_Pages/Core_JavaScript_1.5_Guide/Unicode
/ko/docs/JavaScript/Guide/Obsolete_Pages/Core_JavaScript_1.5_Guide/Values	/ko/docs/Web/JavaScript/Guide/Obsolete_Pages/Core_JavaScript_1.5_Guide/Values
/ko/docs/JavaScript/Guide/Obsolete_Pages/Core_JavaScript_1.5_Guide/Variables	/ko/docs/Web/JavaScript/Guide/Obsolete_Pages/Core_JavaScript_1.5_Guide/Variables
/ko/docs/JavaScript/Guide/Obsolete_Pages/Core_JavaScript_1.5_Guide/Writing_a_Regular_Expression_Pattern	/ko/docs/Web/JavaScript/Guide/Obsolete_Pages/Core_JavaScript_1.5_Guide/Writing_a_Regular_Expression_Pattern
/ko/docs/JavaScript/Guide/Values,_variables,_and_literals	/ko/docs/Web/JavaScript/Guide/Values,_variables,_and_literals
/ko/docs/JavaScript/Introduction_to_Object-Oriented_JavaScript	/ko/docs/Web/JavaScript/Introduction_to_Object-Oriented_JavaScript
/ko/docs/JavaScript/Memory_Management	/ko/docs/Web/JavaScript/Memory_Management
/ko/docs/JavaScript/New_in_JavaScript	/ko/docs/Web/JavaScript/New_in_JavaScript
/ko/docs/JavaScript/New_in_JavaScript/New_in_JavaScript_1.7	/ko/docs/Web/JavaScript/New_in_JavaScript/New_in_JavaScript_1.7
/ko/docs/JavaScript/New_in_JavaScript/New_in_JavaScript_1.8	/ko/docs/Web/JavaScript/New_in_JavaScript/New_in_JavaScript_1.8
/ko/docs/JavaScript/Reference	/ko/docs/Web/JavaScript/Reference
/ko/docs/JavaScript/Reference/About	/ko/docs/Web/JavaScript/Reference/About
/ko/docs/JavaScript/Reference/About/Formatting_Conventions	/ko/docs/Web/JavaScript/Reference/About/Formatting_Conventions
/ko/docs/JavaScript/Reference/Global_Functions	/ko/docs/Web/JavaScript/Reference/Global_Functions
/ko/docs/JavaScript/Reference/Global_Objects	/ko/docs/Web/JavaScript/Reference/Global_Objects
/ko/docs/JavaScript/Reference/Global_Objects/Array	/ko/docs/Web/JavaScript/Reference/Global_Objects/Array
/ko/docs/JavaScript/Reference/Global_Objects/Boolean	/ko/docs/Web/JavaScript/Reference/Global_Objects/Boolean
/ko/docs/JavaScript/Reference/Global_Objects/Date	/ko/docs/Web/JavaScript/Reference/Global_Objects/Date
/ko/docs/JavaScript/Reference/Global_Objects/Error	/ko/docs/Web/JavaScript/Reference/Global_Objects/Error
/ko/docs/JavaScript/Reference/Global_Objects/Function	/ko/docs/Web/JavaScript/Reference/Global_Objects/Function
/ko/docs/JavaScript/Reference/Global_Objects/Function/call	/ko/docs/Web/JavaScript/Reference/Global_Objects/Function/call
/ko/docs/JavaScript/Reference/Global_Objects/Function/prototype	/ko/docs/Web/JavaScript/Reference/Global_Objects/Function/prototype
/ko/docs/JavaScript/Reference/Global_Objects/NaN	/ko/docs/Web/JavaScript/Reference/Global_Objects/NaN
/ko/docs/JavaScript/Reference/Global_Objects/Object	/ko/docs/Web/JavaScript/Reference/Global_Objects/Object
/ko/docs/JavaScript/Reference/Global_Objects/String	/ko/docs/Web/JavaScript/Reference/Global_Objects/String
/ko/docs/JavaScript/Reference/Global_Objects/String/prototype	/ko/docs/Web/JavaScript/Reference/Global_Objects/String/prototype
/ko/docs/JavaScript/Reference/Global_Properties	/ko/docs/Web/JavaScript/Reference/Global_Properties
/ko/docs/JavaScript/Reference/LiveConnect	/ko/docs/Web/JavaScript/Reference/LiveConnect
/ko/docs/JavaScript/Reference/Objects	/ko/docs/Web/JavaScript/Reference/Objects
/ko/docs/JavaScript/Reference/Objects/Function	/ko/docs/Web/JavaScript/Reference/Objects/Function
/ko/docs/JavaScript/Reference/Operators	/ko/docs/Web/JavaScript/Reference/Operators
/ko/docs/JavaScript/Reference/Operators/Bitwise_Operators	/ko/docs/Web/JavaScript/Reference/Operators/Bitwise_Operators
/ko/docs/JavaScript/Reference/Operators/Special_Operators	/ko/docs/Web/JavaScript/Reference/Operators/Special_Operators
/ko/docs/JavaScript/Reference/Operators/this	/ko/docs/Web/JavaScript/Reference/Operators/this
/ko/docs/JavaScript/Reference/Operators/void	/ko/docs/Web/JavaScript/Reference/Operators/void
/ko/docs/JavaScript/Reference/Reserved_Words	/ko/docs/Web/JavaScript/Reference/Reserved_Words
/ko/docs/JavaScript/Reference/Statements	/ko/docs/Web/JavaScript/Reference/Statements
/ko/docs/JavaScript/Reference/Statements/for...in	/ko/docs/Web/JavaScript/Reference/Statements/for...in
/ko/docs/JavaScript/시작하기	/ko/docs/Web/JavaScript/%EC%8B%9C%EC%9E%91%ED%95%98%EA%B8%B0
/ko/docs/JavaScript/언어_리소스	/ko/docs/Web/JavaScript/%EC%96%B8%EC%96%B4_%EB%A6%AC%EC%86%8C%EC%8A%A4
/ko/docs/JavaScript_modules	/ko/docs/Web/JavaScript/Guide/Modules
/ko/docs/JavaScript_technologies_overview	/ko/docs/Web/JavaScript/JavaScript_technologies_overview
/ko/docs/JavaScript_technologies_overview-redirect-1	/ko/docs/JavaScript_technologies_overview
/ko/docs/JavaScript_코드_모듈	/docs/ko/JavaScript_code_modules
/ko/docs/Learn/CSS/Basics	/en-US/docs/Learn/CSS/Introduction_to_CSS
/ko/docs/Learn/CSS/Introduction_to_CSS	/en-US/docs/Learn/CSS/First_steps
/ko/docs/Learn/CSS/Introduction_to_CSS/Attribute_selectors	/en-US/docs/Learn/CSS/Building_blocks/Selectors/Attribute_selectors
/ko/docs/Learn/CSS/Introduction_to_CSS/Cascade_and_inheritance	/en-US/docs/Learn/CSS/Building_blocks/Cascade_and_inheritance
/ko/docs/Learn/CSS/Introduction_to_CSS/Combinators_and_multiple_selectors	/en-US/docs/Learn/CSS/Building_blocks/Selectors/Combinators
/ko/docs/Learn/CSS/Introduction_to_CSS/How_CSS_works	/en-US/docs/Learn/CSS/First_steps/How_CSS_works
/ko/docs/Learn/CSS/Introduction_to_CSS/Pseudo-classes_and_pseudo-elements	/en-US/docs/Learn/CSS/Building_blocks/Selectors/Pseudo-classes_and_pseudo-elements
/ko/docs/Learn/CSS/Introduction_to_CSS/Simple_selectors	/en-US/docs/Learn/CSS/Building_blocks/Selectors/Type_Class_and_ID_Selectors
/ko/docs/Learn/CSS/Introduction_to_CSS/Syntax	/en-US/docs/Learn/CSS/First_steps/How_CSS_is_structured
/ko/docs/Learn/CSS/Introduction_to_CSS/Values_and_units	/en-US/docs/Learn/CSS/Building_blocks/Values_and_units
/ko/docs/Learn/CSS/Introduction_to_CSS/선택자	/en-US/docs/Learn/CSS/Building_blocks/Selectors
/ko/docs/Learn/CSS/Styling_boxes	/en-US/docs/Learn/CSS/Building_blocks
/ko/docs/Learn/CSS/Styling_boxes/Backgrounds	/en-US/docs/Learn/CSS/Building_blocks/Backgrounds_and_borders
/ko/docs/Learn/HTML/Forms/My_first_HTML_form	/ko/docs/Learn/HTML/Forms/Your_first_HTML_form
/ko/docs/Learn/WebGL/By_example	/ko/docs/Web/API/WebGL_API/By_example
/ko/docs/Learn/WebGL/By_example/Clearing_by_clicking	/ko/docs/Web/API/WebGL_API/By_example/Clearing_by_clicking
/ko/docs/Learn/WebGL/By_example/Detect_WebGL	/ko/docs/Web/API/WebGL_API/By_example/Detect_WebGL
/ko/docs/Learn/WebGL/By_example/Hello_GLSL	/ko/docs/Web/API/WebGL_API/By_example/Hello_GLSL
/ko/docs/Learn/WebGL/By_example/Hello_vertex_attributes	/ko/docs/Web/API/WebGL_API/By_example/Hello_vertex_attributes
/ko/docs/Learn/WebGL/By_example/Scissor_animation	/ko/docs/Web/API/WebGL_API/By_example/Scissor_animation
/ko/docs/Learn/WebGL/By_example/Simple_color_animation	/ko/docs/Web/API/WebGL_API/By_example/Simple_color_animation
/ko/docs/Learn/WebGL/By_example/Textures_from_code	/ko/docs/Web/API/WebGL_API/By_example/Textures_from_code
/ko/docs/Listening_to_events	/ko/docs/Archive/Add-ons/Listening_to_events_in_Firefox_extensions
/ko/docs/MDN/Doc_status/Firefox_OS	/ko/docs/MDN/Doc_status/B2G_OS
/ko/docs/MathML	/ko/docs/Web/MathML
/ko/docs/Mozilla's_DOCTYPE_sniffing	/ko/docs/Archive/Web_Standards/Mozilla_s_DOCTYPE_sniffing
/ko/docs/Mozilla/Add-ons/WebExtensions	/ko/docs/Mozilla/%EC%95%A0%EB%93%9C%EC%98%A8%EB%93%A4/WebExtensions
/ko/docs/Mozilla/Add-ons/WebExtensions/Prerequisites	/ko/docs/Mozilla/%EC%95%A0%EB%93%9C%EC%98%A8%EB%93%A4/WebExtensions/Prerequisites
/ko/docs/Mozilla/Add-ons/WebExtensions/manifest.json	/ko/docs/Mozilla/%EC%95%A0%EB%93%9C%EC%98%A8%EB%93%A4/WebExtensions/manifest.json
/ko/docs/Mozilla/B2G_OS/API	/ko/docs/Mozilla/Firefox_OS/API
/ko/docs/Mozilla/B2G_OS/API/Camera_API	/ko/docs/Mozilla/Firefox_OS/API/Camera_API
/ko/docs/Mozilla/B2G_OS/API/Camera_API/Introduction	/ko/docs/Mozilla/Firefox_OS/API/Camera_API/Introduction
/ko/docs/Mozilla/Firefox_OS	/ko/docs/B2G_OS
/ko/docs/Mozilla/Firefox_OS/API	/ko/docs/B2G_OS/API
/ko/docs/Mozilla/Firefox_OS/API/Camera_API	/ko/docs/B2G_OS/API/Camera_API
/ko/docs/Mozilla/Firefox_OS/API/Camera_API/Introduction	/ko/docs/B2G_OS/API/Camera_API/Introduction
/ko/docs/Mozilla/Firefox_OS/Application_development	/ko/docs/B2G_OS/Application_development
/ko/docs/Mozilla/Firefox_OS/Apps	/ko/docs/B2G_OS/Apps
/ko/docs/Mozilla/Firefox_OS/Apps/Writing_a_web_app_for_Firefox_OS	/ko/docs/B2G_OS/Apps/Writing_a_web_app_for_Firefox_OS
/ko/docs/Mozilla/Firefox_OS/Architecture	/ko/docs/B2G_OS/Platform/Architecture
/ko/docs/Mozilla/Firefox_OS/Boot_to_Gecko_developer_phone_guide	/ko/docs/B2G_OS/Boot_to_Gecko_developer_phone_guide
/ko/docs/Mozilla/Firefox_OS/Building	/ko/docs/B2G_OS/Building
/ko/docs/Mozilla/Firefox_OS/Building_and_installing_Firefox_OS	/ko/docs/B2G_OS/Building_and_installing_Firefox_OS
/ko/docs/Mozilla/Firefox_OS/Debugging	/ko/docs/B2G_OS/Debugging
/ko/docs/Mozilla/Firefox_OS/Debugging/Debugging_B2G_using_gdb	/ko/docs/B2G_OS/Debugging/Debugging_B2G_using_gdb
/ko/docs/Mozilla/Firefox_OS/Dual_boot_of_B2G_and_Android_on_SGS2	/ko/docs/B2G_OS/Dual_boot_of_B2G_and_Android_on_SGS2
/ko/docs/Mozilla/Firefox_OS/Firefox_OS_FAQ	/ko/docs/B2G_OS/Firefox_OS_FAQ
/ko/docs/Mozilla/Firefox_OS/Firefox_OS_build_prerequisites	/ko/docs/B2G_OS/Firefox_OS_build_prerequisites
/ko/docs/Mozilla/Firefox_OS/Installing_on_a_mobile_device	/ko/docs/B2G_OS/Installing_on_a_mobile_device
/ko/docs/Mozilla/Firefox_OS/Introduction	/ko/docs/B2G_OS/Introduction
/ko/docs/Mozilla/Firefox_OS/Pandaboard	/ko/docs/B2G_OS/Pandaboard
/ko/docs/Mozilla/Firefox_OS/Platform	/ko/docs/B2G_OS/Platform
/ko/docs/Mozilla/Firefox_OS/Platform/Gonk	/ko/docs/B2G_OS/Platform/Gonk
/ko/docs/Mozilla/Firefox_OS/Platform/Testing	/ko/docs/B2G_OS/Platform/Testing
/ko/docs/Mozilla/Firefox_OS/Porting	/ko/docs/B2G_OS/Porting
/ko/docs/Mozilla/Firefox_OS/Preparing_for_your_first_B2G_build	/ko/docs/B2G_OS/Preparing_for_your_first_B2G_build
/ko/docs/Mozilla/Firefox_OS/Security	/ko/docs/B2G_OS/Security
/ko/docs/Mozilla/Firefox_OS/Security/보안_모델	/ko/docs/B2G_OS/Security/%EB%B3%B4%EC%95%88_%EB%AA%A8%EB%8D%B8
/ko/docs/Mozilla/Firefox_OS/Using_Gaia_in_Firefox	/ko/docs/B2G_OS/Using_Gaia_in_Firefox
/ko/docs/Mozilla/Firefox_OS/성능	/ko/docs/B2G_OS/%EC%84%B1%EB%8A%A5
/ko/docs/Mozilla/Firefox_OS/앱_관리자_사용하기	/ko/docs/B2G_OS/%EC%95%B1_%EA%B4%80%EB%A6%AC%EC%9E%90_%EC%82%AC%EC%9A%A9%ED%95%98%EA%B8%B0
/ko/docs/Mozilla/Marketplace/Publishing	/en-US/Marketplace/Publishing/Introduction
/ko/docs/Mozilla/Tech/XPCOM/Reference/Interface	/ko/docs/XPCOM_Interface_Reference
/ko/docs/New_in_JavaScript_1.6	/ko/docs/Web/JavaScript/New_in_JavaScript/1.6
/ko/docs/New_in_JavaScript_1.7	/ko/docs/JavaScript/New_in_JavaScript/New_in_JavaScript_1.7
/ko/docs/New_in_JavaScript_1.8	/ko/docs/JavaScript/New_in_JavaScript/New_in_JavaScript_1.8
/ko/docs/Online_and_offline_events	/ko/docs/Web/API/NavigatorOnLine/Online_and_offline_events
/ko/docs/Participating_in_the_Mozilla_project	/ko/docs/Mozilla/Participating_in_the_Mozilla_project
/ko/docs/Persona	/ko/docs/Mozilla/Persona
/ko/docs/Persona/Bootstrapping_Persona	/ko/docs/Mozilla/Persona/Bootstrapping_Persona
/ko/docs/Persona/Browser_compatibility	/ko/docs/Mozilla/Persona/Browser_compatibility
/ko/docs/Persona/Why_Persona	/ko/docs/Mozilla/Persona/Why_Persona
/ko/docs/Places:Accessing_Bookmarks	/docs/ko/Places/Accessing_Bookmarks
/ko/docs/Places:Custom_Containers	/docs/ko/Places/Custom_Containers
/ko/docs/Places:Instantiating_Views	/docs/ko/Places/Instantiating_Views
/ko/docs/Places:Query_System	/docs/ko/Places/Query_System
/ko/docs/Places:Views	/docs/ko/Places/Views
/ko/docs/Preferences_System:Examples	/docs/ko/Preferences_System/Examples
/ko/docs/Project:Examples:Alternate_License_Block	/docs/Project:ko/Examples/Alternate_License_Block
/ko/docs/Project:Korean	/docs/Project:ko
/ko/docs/Project:Korean_Contributors_사랑방	/docs/Project:ko/%EC%82%AC%EB%9E%91%EB%B0%A9
/ko/docs/Project:MDN	/ko/docs/MDN
/ko/docs/Project:MDN/Contributing	/ko/docs/MDN/Contribute
/ko/docs/Project:Policies_and_guidelines	/docs/Project:ko/How_to_Help
/ko/docs/Project:en	/en-US/docs/MDN/About
/ko/docs/Project:소개	/docs/Project:ko/About
/ko/docs/Project:저작권	/docs/Project:ko/Copyrights
/ko/docs/QA	/ko/docs/Mozilla/QA
/ko/docs/RDF_Datasource_How-To	/ko/docs/Archive/Mozilla/RDF_Datasource_How-To
/ko/docs/RDF_in_Fifty_Words_or_Less	/ko/docs/Archive/Web_Standards/RDF_in_Fifty_Words_or_Less
/ko/docs/RDF_in_Mozilla_FAQ	/ko/docs/Archive/Web_Standards/RDF_in_Mozilla_FAQ
/ko/docs/RSS	/ko/docs/Archive/RSS
/ko/docs/RSS/Getting_Started	/ko/docs/Archive/RSS/Getting_Started
/ko/docs/RSS/Getting_Started/What_is_RSS	/ko/docs/Archive/RSS/Getting_Started/What_is_RSS
/ko/docs/RSS/Module	/ko/docs/Archive/RSS/Module
/ko/docs/RSS/Version	/ko/docs/Archive/RSS/Version
/ko/docs/RSS:Getting_Started	/docs/ko/RSS/Getting_Started
/ko/docs/RSS:Getting_Started:What_is_RSS	/docs/ko/RSS/Getting_Started/What_is_RSS
/ko/docs/RSS:Module	/docs/ko/RSS/Module
/ko/docs/RSS:Version	/docs/ko/RSS/Version
/ko/docs/SVG	/ko/docs/Web/SVG
/ko/docs/SVG/Tutorial	/ko/docs/Web/SVG/Tutorial
/ko/docs/SVG:Tutorial	/docs/ko/SVG/Tutorial
/ko/docs/SVG_In_HTML_Introduction	/ko/docs/Web/SVG/Tutorial/SVG_In_HTML_Introduction
/ko/docs/Scripting_Plugins:_Macromedia_Flash	/docs/ko/Scripting_Plugins/Macromedia_Flash
/ko/docs/Security/CSP/Using_Content_Security_Policy	/ko/docs/Web/HTTP/CSP
/ko/docs/Setting_HTTP_request_headers	/ko/docs/XPCOM/Setting_HTTP_request_headers
/ko/docs/The_Importance_of_Correct_HTML_Commenting	/ko/docs/Learn/HTML/Introduction_to_HTML/Getting_started#HTML_comments
/ko/docs/The_Thread_Manager	/ko/docs/XPCOM/The_Thread_Manager
/ko/docs/The_XSLT_JavaScript_Interface_in_Gecko	/ko/docs/Web/XSLT/The_XSLT_JavaScript_Interface_in_Gecko
/ko/docs/The_XSLT_JavaScript_Interface_in_Gecko/Basic_Example	/ko/docs/Web/XSLT/The_XSLT_JavaScript_Interface_in_Gecko/Basic_Example
/ko/docs/The_XSLT_JavaScript_Interface_in_Gecko/Introduction	/ko/docs/Web/XSLT/The_XSLT_JavaScript_Interface_in_Gecko/Introduction
/ko/docs/The_XSLT_JavaScript_Interface_in_Gecko/JavaScript_XSLT_Bindings	/ko/docs/Web/XSLT/The_XSLT_JavaScript_Interface_in_Gecko/JavaScript_XSLT_Bindings
/ko/docs/The_XSLT_JavaScript_Interface_in_Gecko/Setting_Parameters	/ko/docs/Web/XSLT/The_XSLT_JavaScript_Interface_in_Gecko/Setting_Parameters
/ko/docs/The_XSLT_JavaScript_Interface_in_Gecko:Basic_Example	/docs/ko/The_XSLT//JavaScript_Interface_in_Gecko/Basic_Example
/ko/docs/The_XSLT_JavaScript_Interface_in_Gecko:Introduction	/docs/ko/The_XSLT//JavaScript_Interface_in_Gecko/Introduction
/ko/docs/The_XSLT_JavaScript_Interface_in_Gecko:JavaScript_XSLT_Bindings	/docs/ko/The_XSLT//JavaScript_Interface_in_Gecko/JavaScript//XSLT_Bindings
/ko/docs/The_XSLT_JavaScript_Interface_in_Gecko:Setting_Parameters	/docs/ko/The_XSLT//JavaScript_Interface_in_Gecko/Setting_Parameters
/ko/docs/Toolkit_API/Official_References	/docs/Template:Toolkit_API_Official_References
/ko/docs/Toolkit_API:Official_References	/docs/ko/Toolkit_API/Official_References
/ko/docs/Tools/Scratchpad	/ko/docs/%EB%8F%84%EA%B5%AC%EB%93%A4/Scratchpad
/ko/docs/Transforming_XML_with_XSLT	/ko/docs/Web/XSLT/Transforming_XML_with_XSLT
/ko/docs/Transforming_XML_with_XSLT/The_Netscape_XSLT_XPath_Reference	/ko/docs/Web/XSLT/Transforming_XML_with_XSLT/The_Netscape_XSLT_XPath_Reference
/ko/docs/Transforming_XML_with_XSLT:The_Netscape_XSLT_XPath_Reference	/docs/ko/Transforming_XML_with_XSLT/The_Netscape_XSLT//XPath_Reference
/ko/docs/Traversing_an_HTML_table_with_JavaScript_and_DOM_Interfaces	/ko/docs/Web/API/Document_Object_Model/Traversing_an_HTML_table_with_JavaScript_and_DOM_Interfaces
/ko/docs/Using_URL_values_for_the_cursor_property	/ko/docs/CSS/cursor/Using_URL_values_for_the_cursor_property
/ko/docs/Using_URL_values_for_the_cursor_property-redirect-1	/ko/docs/Using_URL_values_for_the_cursor_property
/ko/docs/Using_content_preferences	/ko/docs/Archive/Misc_top_level/Using_content_preferences
/ko/docs/Using_microformats	/ko/docs/Archive/Mozilla/Firefox/Using_microformats
/ko/docs/Using_the_Mozilla_JavaScript_interface_to_XSL_Transformations	/ko/docs/Web/XSLT/Using_the_Mozilla_JavaScript_interface_to_XSL_Transformations
/ko/docs/Using_the_Right_Markup_to_Invoke_Plugins	/ko/docs/Archive/Web_Standards/Using_the_Right_Markup_to_Invoke_Plugins
/ko/docs/Web/API/AudioBufferSourceNode/stop	/ko/docs/Web/API/AudioScheduledSourceNode/stop
/ko/docs/Web/API/Boolean	/ko/docs/Web/JavaScript/Reference/Global_Objects/Boolean
/ko/docs/Web/API/Document/defaultView/popstate_event	/ko/docs/Web/API/Window/popstate_event
/ko/docs/Web/API/Document/defaultView/resize_event	/ko/docs/Web/API/Window/resize_event
/ko/docs/Web/API/Document_Object_Model/Preface	/ko/docs/Web/API/Document_Object_Model
/ko/docs/Web/API/Element.clientHeight	/ko/docs/Web/API/Element/clientHeight
/ko/docs/Web/API/Element.getAttribute	/ko/docs/Web/API/Element/getAttribute
/ko/docs/Web/API/Element/childNodes	/ko/docs/Web/API/Node/childNodes
/ko/docs/Web/API/Element/firstChild	/ko/docs/Web/API/Node/firstChild
/ko/docs/Web/API/FileReader.result	/ko/docs/Web/API/FileReader/result
/ko/docs/Web/API/Navigator.battery	/ko/docs/Web/API/Navigator/battery
/ko/docs/Web/API/Navigator.battery/window.navigator.battery	/ko/docs/Web/API/Navigator.battery
/ko/docs/Web/API/Navigator.connection/window.navigator.connection	/ko/docs/Web/API/NetworkInformation.connection/window.navigator.connection
/ko/docs/Web/API/NetworkInformation.connection	/ko/docs/Web/API/NetworkInformation/connection
/ko/docs/Web/API/NetworkInformation.connection/window.navigator.connection	/ko/docs/Web/API/NetworkInformation.connection
/ko/docs/Web/API/Notification.permission	/ko/docs/Web/API/Notification/permission
/ko/docs/Web/API/Position	/ko/docs/Web/API/GeolocationPosition
/ko/docs/Web/API/RandomSource	/ko/docs/Web/API/Crypto/getRandomValues
/ko/docs/Web/API/Screen.lockOrientation	/ko/docs/Web/API/Screen/lockOrientation
/ko/docs/Web/API/Screen.lockOrientation/window.screen.lockOrientation	/ko/docs/Web/API/Screen.lockOrientation
/ko/docs/Web/API/Screen.onorientationchange/window.screen.onorientationchange	/ko/docs/Web/API/Screen.onorientationchange
/ko/docs/Web/API/Screen.orientation	/ko/docs/Web/API/Screen/orientation
/ko/docs/Web/API/Screen.orientation/window.screen.orientation	/ko/docs/Web/API/Screen.orientation
/ko/docs/Web/API/WebGL_API/Adding_2D_content_to_a_WebGL_context	/ko/docs/Web/API/WebGL_API/Tutorial/Adding_2D_content_to_a_WebGL_context
/ko/docs/Web/API/WebGL_API/Animating_objects_with_WebGL	/ko/docs/Web/API/WebGL_API/Tutorial/Animating_objects_with_WebGL
/ko/docs/Web/API/WebGL_API/Animating_textures_in_WebGL	/ko/docs/Web/API/WebGL_API/Tutorial/Animating_textures_in_WebGL
/ko/docs/Web/API/WebGL_API/Creating_3D_objects_using_WebGL	/ko/docs/Web/API/WebGL_API/Tutorial/Creating_3D_objects_using_WebGL
/ko/docs/Web/API/WebGL_API/Getting_started_with_WebGL	/ko/docs/Web/API/WebGL_API/Tutorial/Getting_started_with_WebGL
/ko/docs/Web/API/WebGL_API/Lighting_in_WebGL	/ko/docs/Web/API/WebGL_API/Tutorial/Lighting_in_WebGL
/ko/docs/Web/API/WebGL_API/Using_shaders_to_apply_color_in_WebGL	/ko/docs/Web/API/WebGL_API/Tutorial/Using_shaders_to_apply_color_in_WebGL
/ko/docs/Web/API/WebGL_API/Using_textures_in_WebGL	/ko/docs/Web/API/WebGL_API/Tutorial/Using_textures_in_WebGL
/ko/docs/Web/API/WindowBase64	/ko/docs/Web/API/WindowOrWorkerGlobalScope
/ko/docs/Web/API/WindowTimers	/ko/docs/Web/API/WindowOrWorkerGlobalScope
/ko/docs/Web/API/document.importNode	/ko/docs/Web/API/Document/importNode
/ko/docs/Web/API/element-temp	/ko/docs/Web/API/Element
/ko/docs/Web/API/window.navigator.battery	/ko/docs/Web/API/Navigator.battery/window.navigator.battery
/ko/docs/Web/API/window.navigator.connection	/ko/docs/Web/API/Navigator.connection/window.navigator.connection
/ko/docs/Web/API/window.navigator.mozMobileMessage	/ko/docs/Web/API/Navigator/mozMobileMessage
/ko/docs/Web/API/window.navigator.mozNotification	/ko/docs/Web/API/Navigator/mozNotification
/ko/docs/Web/API/window.navigator.mozSms	/ko/docs/Web/API/Navigator/mozSms
/ko/docs/Web/API/window.screen.lockOrientation	/ko/docs/Web/API/Screen.lockOrientation/window.screen.lockOrientation
/ko/docs/Web/API/window.screen.onorientationchange	/ko/docs/Web/API/Screen.onorientationchange/window.screen.onorientationchange
/ko/docs/Web/API/window.screen.orientation	/ko/docs/Web/API/Screen.orientation/window.screen.orientation
/ko/docs/Web/API/window.screen.unlockOrientation	/ko/docs/Web/API/Screen/unlockOrientation
/ko/docs/Web/Apps/Quickstart/Build	/ko/docs/Archive/B2G_OS/Quickstart
/ko/docs/Web/Apps/Quickstart/Build/Intro_to_Firefox_OS	/ko/docs/Archive/B2G_OS/Quickstart/Intro_to_Firefox_OS
/ko/docs/Web/Apps/Quickstart/Build/Intro_to_open_web_apps	/ko/docs/Archive/B2G_OS/Quickstart/Intro_to_open_web_apps
/ko/docs/Web/CSS/CSS3	/ko/docs/Archive/CSS3
/ko/docs/Web/CSS/CSS_Background_and_Borders	/ko/docs/Web/CSS/CSS_Backgrounds_and_Borders
/ko/docs/Web/CSS/CSS_Colors	/ko/docs/Web/CSS/CSS_Color
/ko/docs/Web/CSS/CSS_Compositing_and_Blending	/ko/docs/Web/CSS/Compositing_and_Blending
/ko/docs/Web/CSS/CSS_Flexible_Box_Layout/Using_CSS_flexible_boxes	/ko/docs/Web/CSS/CSS_Flexible_Box_Layout/Basic_Concepts_of_Flexbox
/ko/docs/Web/CSS/CSS_Grid_Layout/CSS_그리드의_라인을_기준으로_한_아이템_배치	/ko/docs/Web/CSS/CSS_Grid_Layout/Line-based_placement_with_CSS_grid
/ko/docs/Web/CSS/CSS_Grid_Layout/그리드_레이아웃과_다른_레이아웃_방법과의_관계	/ko/docs/Web/CSS/CSS_Grid_Layout/Relationship_of_grid_layout
/ko/docs/Web/CSS/CSS_Grid_Layout/그리드_레이아웃의_기본_개념	/ko/docs/Web/CSS/CSS_Grid_Layout/Basic_concepts_of_grid_layout
/ko/docs/Web/CSS/CSS_Grid_Layout/그리드_템플릿_영역	/ko/docs/Web/CSS/CSS_Grid_Layout/Grid_template_areas
/ko/docs/Web/CSS/CSS_Grid_Layout/이름이_주어진_그리드_라인을_이용한_레이아웃	/ko/docs/Web/CSS/CSS_Grid_Layout/Layout_using_named_grid_lines
/ko/docs/Web/CSS/CSS_Reference	/ko/docs/Web/CSS/Reference
/ko/docs/Web/CSS/CSS_Reference/Property_Template	/ko/docs/Web/CSS/Reference/Property_Template
/ko/docs/Web/CSS/CSS_User_Interface	/ko/docs/Web/CSS/CSS_Basic_User_Interface
/ko/docs/Web/CSS/Getting_Started	/ko/docs/CSS/시작하기
/ko/docs/Web/CSS/Getting_Started/Boxes	/ko/docs/CSS/%EC%8B%9C%EC%9E%91%ED%95%98%EA%B8%B0/%EC%83%81%EC%9E%90
/ko/docs/Web/CSS/Getting_Started/Cascading_and_inheritance	/ko/docs/CSS/%EC%8B%9C%EC%9E%91%ED%95%98%EA%B8%B0/%EC%A2%85%EC%86%8D%EA%B3%BC_%EC%83%81%EC%86%8D
/ko/docs/Web/CSS/Getting_Started/Color	/ko/docs/CSS/%EC%8B%9C%EC%9E%91%ED%95%98%EA%B8%B0/%EC%83%89%EC%83%81
/ko/docs/Web/CSS/Getting_Started/Content	/ko/docs/CSS/%EC%8B%9C%EC%9E%91%ED%95%98%EA%B8%B0/%EB%82%B4%EC%9A%A9%EB%AC%BC
/ko/docs/Web/CSS/Getting_Started/How_CSS_works	/ko/docs/CSS/%EC%8B%9C%EC%9E%91%ED%95%98%EA%B8%B0/CSS_%EB%8F%99%EC%9E%91_%EC%9B%90%EB%A6%AC
/ko/docs/Web/CSS/Getting_Started/Layout	/ko/docs/CSS/%EC%8B%9C%EC%9E%91%ED%95%98%EA%B8%B0/%EB%B0%B0%EC%B9%98
/ko/docs/Web/CSS/Getting_Started/Lists	/ko/docs/Web/CSS/시작하기/리스트
/ko/docs/Web/CSS/Getting_Started/Media	/ko/docs/Web/CSS/%EC%8B%9C%EC%9E%91%ED%95%98%EA%B8%B0/%EB%AF%B8%EB%94%94%EC%96%B4
/ko/docs/Web/CSS/Getting_Started/Readable_CSS	/ko/docs/Web/CSS/시작하기/알기_쉬운_CSS
/ko/docs/Web/CSS/Getting_Started/Selectors	/ko/docs/Web/CSS/시작하기/설렉터
/ko/docs/Web/CSS/Getting_Started/Tables	/ko/docs/Web/CSS/시작하기/테이블
/ko/docs/Web/CSS/Getting_Started/Text_styles	/ko/docs/Web/CSS/시작하기/텍스트_스타일
/ko/docs/Web/CSS/Getting_Started/What_is_CSS	/ko/docs/Web/CSS/%EC%8B%9C%EC%9E%91%ED%95%98%EA%B8%B0/CSS%EB%9E%80
/ko/docs/Web/CSS/Getting_Started/Why_use_CSS	/ko/docs/Web/CSS/%EC%8B%9C%EC%9E%91%ED%95%98%EA%B8%B0/%EC%99%9C_CSS%EB%A5%BC_%EC%82%AC%EC%9A%A9%ED%95%98%EB%82%98
/ko/docs/Web/CSS/Scaling_background_images	/ko/docs/Web/CSS/CSS_Backgrounds_and_Borders/Scaling_background_images
/ko/docs/Web/CSS/Using_CSS_animations	/ko/docs/Web/CSS/CSS_Animations/Using_CSS_animations
/ko/docs/Web/CSS/Using_CSS_multiple_backgrounds	/ko/docs/Web/CSS/CSS_Background_and_Borders/Using_CSS_multiple_backgrounds
/ko/docs/Web/CSS/Using_CSS_transforms	/ko/docs/Web/CSS/CSS_Transforms/Using_CSS_transforms
/ko/docs/Web/CSS/Using_CSS_variables	/ko/docs/Web/CSS/Using_CSS_custom_properties
/ko/docs/Web/CSS/currentcolor	/ko/docs/Web/CSS/color_value#currentColor_키워드
/ko/docs/Web/CSS/시작하기	/ko/docs/Learn/CSS/Introduction_to_CSS
/ko/docs/Web/CSS/시작하기/CSS_동작_원리	/ko/docs/Learn/CSS/Introduction_to_CSS/How_CSS_works
/ko/docs/Web/CSS/시작하기/CSS란	/ko/docs/Learn/CSS/Introduction_to_CSS/How_CSS_works
/ko/docs/Web/CSS/시작하기/내용물	/ko/docs/Learn/CSS/Howto/Generated_content
/ko/docs/Web/CSS/시작하기/색상	/ko/docs/Learn/CSS/Introduction_to_CSS/Values_and_units
/ko/docs/Web/CSS/시작하기/설렉터	/ko/docs/Learn/CSS/Introduction_to_CSS/%EC%84%A0%ED%83%9D%EC%9E%90
/ko/docs/Web/CSS/시작하기/알기_쉬운_CSS	/ko/docs/Learn/CSS/Introduction_to_CSS/Syntax#구문_그_너머_읽기_편한_CSS
/ko/docs/Web/CSS/시작하기/왜_CSS를_사용하나	/ko/docs/Learn/CSS/Introduction_to_CSS/How_CSS_works
/ko/docs/Web/Events/canplay	/ko/docs/Web/HTML/Element/Video/canplay_event
/ko/docs/Web/Events/canplaythrough	/ko/docs/Web/HTML/Element/Video/canplaythrough_event
/ko/docs/Web/Events/canplaythrough_event	/ko/docs/Web/HTML/Element/audio/canplaythrough_event
/ko/docs/Web/Events/click	/ko/docs/Web/API/Element/click_event
/ko/docs/Web/Events/dragstart	/ko/docs/Web/API/Document/dragstart_event
/ko/docs/Web/Events/keydown	/ko/docs/Web/API/Document/keydown_event
/ko/docs/Web/Events/loadedmetadata	/ko/docs/Web/HTML/Element/Video/loadedmetadata_event
/ko/docs/Web/Events/loadedmetadata_event	/ko/docs/Web/HTML/Element/audio/loadedmetadata_event
/ko/docs/Web/Events/orientationchange	/ko/docs/Web/API/Window/orientationchange_event
/ko/docs/Web/Events/popstate	/ko/docs/Web/API/Document/defaultView/popstate_event
/ko/docs/Web/Events/resize	/ko/docs/Web/API/Document/defaultView/resize_event
/ko/docs/Web/Events/scroll	/ko/docs/Web/API/Document/scroll_event
/ko/docs/Web/Events/timeout	/ko/docs/Web/API/XMLHttpRequest/timeout
/ko/docs/Web/Events/touchcancel	/ko/docs/Web/API/Element/touchcancel_event
/ko/docs/Web/Events/visibilitychange	/ko/docs/Web/API/Document/visibilitychange_event
/ko/docs/Web/Guide/CSS	/ko/docs/Learn/CSS
/ko/docs/Web/Guide/CSS/Using_CSS_transitions	/ko/docs/Web/CSS/CSS_Transitions/Using_CSS_transitions
/ko/docs/Web/Guide/HTML	/ko/docs/Learn/HTML
/ko/docs/Web/Guide/HTML/Content_categories	/ko/docs/Web/Guide/HTML/%EC%BB%A8%ED%85%90%ED%8A%B8_%EC%B9%B4%ED%85%8C%EA%B3%A0%EB%A6%AC
/ko/docs/Web/Guide/HTML/폼	/ko/docs/Learn/HTML/Forms
/ko/docs/Web/Guide/HTML/폼/HTML_폼_구성_방법	/ko/docs/Learn/HTML/Forms/HTML_%ED%8F%BC_%EA%B5%AC%EC%84%B1_%EB%B0%A9%EB%B2%95
/ko/docs/Web/Guide/HTML/폼/My_first_HTML_form	/ko/docs/Learn/HTML/Forms/My_first_HTML_form
/ko/docs/Web/Guide/HTML/폼/Sending_and_retrieving_form_data	/ko/docs/Learn/HTML/Forms/Sending_and_retrieving_form_data
/ko/docs/Web/HTML/Element/Video/canplay_event	/ko/docs/Web/API/HTMLMediaElement/canplay_event
/ko/docs/Web/HTML/Element/Video/canplaythrough_event	/ko/docs/Web/API/HTMLMediaElement/canplaythrough_event
/ko/docs/Web/HTML/Element/Video/loadedmetadata_event	/ko/docs/Web/API/HTMLMediaElement/loadedmetadata_event
/ko/docs/Web/HTML/Element/h1	/ko/docs/Web/HTML/Element/Heading_Elements
/ko/docs/Web/HTML/Element/h2	/ko/docs/Web/HTML/Element/Heading_Elements
/ko/docs/Web/HTML/Element/h3	/ko/docs/Web/HTML/Element/Heading_Elements
/ko/docs/Web/HTML/Element/h4	/ko/docs/Web/HTML/Element/Heading_Elements
/ko/docs/Web/HTML/Element/h5	/ko/docs/Web/HTML/Element/Heading_Elements
/ko/docs/Web/HTML/Element/h6	/ko/docs/Web/HTML/Element/Heading_Elements
/ko/docs/Web/HTML/Focus_management_in_HTML	/ko/docs/Web/API/Document/hasFocus
/ko/docs/Web/HTML/HTML5/HTML5_element_list	/ko/docs/Web/HTML/Element
/ko/docs/Web/HTML/Introduction	/ko/docs/Learn/HTML/Introduction_to_HTML
/ko/docs/Web/HTTP/상태_코드	/ko/docs/Web/HTTP/Status
/ko/docs/Web/JavaScript/Guide/About	/ko/docs/Web/JavaScript/Guide/%EC%86%8C%EA%B0%9C
/ko/docs/Web/JavaScript/Guide/Obsolete_Pages/Core_JavaScript_1.5_Guide	/ko/docs/Web/JavaScript/Guide
/ko/docs/Web/JavaScript/Guide/Obsolete_Pages/Core_JavaScript_1.5_Guide/Creating_New_Objects/Using_Object_Initializers	/docs/ko/Core_JavaScript_1.5_Guide/Creating_New_Objects/Using_Object_Initializers
/ko/docs/Web/JavaScript/Guide/Predefined_Core_Objects	/ko/docs/Web/JavaScript/Guide
/ko/docs/Web/JavaScript/New_in_JavaScript/ECMAScript_7_support_in_Mozilla	/ko/docs/Archive/Web/JavaScript/ECMAScript_7_support_in_Mozilla
/ko/docs/Web/JavaScript/New_in_JavaScript/New_in_JavaScript_1.7	/ko/docs/Web/JavaScript/New_in_JavaScript/1.7
/ko/docs/Web/JavaScript/New_in_JavaScript/New_in_JavaScript_1.8	/ko/docs/Web/JavaScript/New_in_JavaScript/1.8
/ko/docs/Web/JavaScript/Reference/Global_Functions	/ko/docs/Core_JavaScript_1.5_Reference/Global_Objects
/ko/docs/Web/JavaScript/Reference/Global_Objects/Array/constructor	/ko/docs/Web/JavaScript/Reference/Global_Objects/Array
/ko/docs/Web/JavaScript/Reference/Global_Objects/Boolean/constructor	/ko/docs/Web/JavaScript/Reference/Global_Objects/Boolean
/ko/docs/Web/JavaScript/Reference/Global_Objects/Date/constructor	/ko/docs/Web/JavaScript/Reference/Global_Objects/Date
/ko/docs/Web/JavaScript/Reference/Global_Properties	/ko/docs/Core_JavaScript_1.5_Reference/Global_Objects
/ko/docs/Web/JavaScript/Reference/Objects	/ko/docs/Web/JavaScript/Reference/Global_Objects
/ko/docs/Web/JavaScript/Reference/Objects/Function	/docs/ko/Core_JavaScript_1.5_Reference/Global_Objects/Function
/ko/docs/Web/JavaScript/Reference/Operators/Special_Operators	/ko/docs/Core_JavaScript_1.5_Reference/Operators
/ko/docs/Web/JavaScript/Reference/Operators/Spread_operator	/ko/docs/Web/JavaScript/Reference/Operators/Spread_syntax
/ko/docs/Web/JavaScript/Tutorials	/ko/docs/Web/JavaScript
/ko/docs/Web/Reference/Events	/ko/docs/Web/Events
/ko/docs/Web/Reference/Events/DOMContentLoaded	/ko/docs/Web/Events/DOMContentLoaded
/ko/docs/Web/Reference/Events/DOMSubtreeModified	/ko/docs/Web/Events/DOMSubtreeModified
/ko/docs/Web/Reference/Events/beforeunload	/ko/docs/Web/Events/beforeunload
/ko/docs/Web/Reference/Events/blur	/ko/docs/Web/Events/blur
/ko/docs/Web/Reference/Events/canplay	/ko/docs/Web/Events/canplay
/ko/docs/Web/Reference/Events/canplaythrough	/ko/docs/Web/Events/canplaythrough
/ko/docs/Web/Reference/Events/chargingchange	/ko/docs/Web/Events/chargingchange
/ko/docs/Web/Reference/Events/click	/ko/docs/Web/Events/click
/ko/docs/Web/Reference/Events/keydown	/ko/docs/Web/Events/keydown
/ko/docs/Web/Reference/Events/load	/ko/docs/Web/Events/load
/ko/docs/Web/Reference/Events/loadedmetadata	/ko/docs/Web/Events/loadedmetadata
/ko/docs/Web/Reference/Events/message	/ko/docs/Web/Events/message
/ko/docs/Web/Reference/Events/orientationchange	/ko/docs/Web/Events/orientationchange
/ko/docs/Web/Reference/Events/popstate	/ko/docs/Web/Events/popstate
/ko/docs/Web/Reference/Events/progress	/ko/docs/Web/Events/progress
/ko/docs/Web/Reference/Events/resize	/ko/docs/Web/Events/resize
/ko/docs/Web/Reference/Events/timeout	/ko/docs/Web/Events/timeout
/ko/docs/Web/Reference/Events/touchcancel	/ko/docs/Web/Events/touchcancel
/ko/docs/Web/Reference/Events/visibilitychange	/ko/docs/Web/Events/visibilitychange
/ko/docs/Web/WebGL	/ko/docs/Web/API/WebGL_API
/ko/docs/Web/WebGL/Adding_2D_content_to_a_WebGL_context	/ko/docs/Web/API/WebGL_API/Adding_2D_content_to_a_WebGL_context
/ko/docs/Web/WebGL/Animating_objects_with_WebGL	/ko/docs/Web/API/WebGL_API/Animating_objects_with_WebGL
/ko/docs/Web/WebGL/Animating_textures_in_WebGL	/ko/docs/Web/API/WebGL_API/Animating_textures_in_WebGL
/ko/docs/Web/WebGL/Creating_3D_objects_using_WebGL	/ko/docs/Web/API/WebGL_API/Creating_3D_objects_using_WebGL
/ko/docs/Web/WebGL/Cross-Domain_Textures	/ko/docs/Web/API/WebGL_API/Cross-Domain_Textures
/ko/docs/Web/WebGL/Getting_started_with_WebGL	/ko/docs/Web/API/WebGL_API/Getting_started_with_WebGL
/ko/docs/Web/WebGL/Lighting_in_WebGL	/ko/docs/Web/API/WebGL_API/Lighting_in_WebGL
/ko/docs/Web/WebGL/Using_shaders_to_apply_color_in_WebGL	/ko/docs/Web/API/WebGL_API/Using_shaders_to_apply_color_in_WebGL
/ko/docs/Web/WebGL/Using_textures_in_WebGL	/ko/docs/Web/API/WebGL_API/Using_textures_in_WebGL
/ko/docs/Web/Web_Components/Custom_Elements	/ko/docs/Web/Web_Components/Using_custom_elements
/ko/docs/Web/Web_Components/Shadow_DOM	/ko/docs/Web/Web_Components/Using_shadow_DOM
/ko/docs/Web/XSLT/Elements	/ko/docs/Web/XSLT/Element
/ko/docs/Web/XSLT/Elements/element	/ko/docs/Web/XSLT/Element/element
/ko/docs/WebAPI/Vibration	/ko/docs/Web/Guide/API/Vibration/Vibration
/ko/docs/WebAPI/WebSMS/Introduction_to_WebSMS	/ko/docs/WebAPI/WebSMS/Introduction_to_Mobile_Message_API/Introduction_to_WebSMS
/ko/docs/Web_Standards	/ko/docs/Archive/Web_Standards
/ko/docs/Writing_Efficient_CSS	/docs/ko/CSS/Writing_Efficient_CSS
/ko/docs/XBL	/ko/docs/Archive/Mozilla/XBL
/ko/docs/XBL/XBL_1.0_Reference	/ko/docs/Archive/Mozilla/XBL/XBL_1.0_Reference
/ko/docs/XBL/XBL_1.0_Reference/Elements	/ko/docs/Archive/Mozilla/XBL/XBL_1.0_Reference/Elements
/ko/docs/XBL:XBL_1.0_Reference	/docs/ko/XBL/XBL_1.0_Reference
/ko/docs/XBL:XBL_1.0_Reference:Elements	/docs/ko/XBL/XBL_1.0_Reference/Elements
/ko/docs/XMLHttpRequest	/ko/docs/Web/API/XMLHttpRequest
/ko/docs/XMLHttpRequest/Synchronous_and_Asynchronous_Requests	/ko/docs/Web/API/XMLHttpRequest/Synchronous_and_Asynchronous_Requests
/ko/docs/XMLHttpRequest/Using_XMLHttpRequest	/ko/docs/Web/API/XMLHttpRequest/Using_XMLHttpRequest
/ko/docs/XMLHttpRequest/setRequestHeader	/ko/docs/Web/API/XMLHttpRequest/setRequestHeader
/ko/docs/XML_Introduction	/ko/docs/Web/XML/XML_Introduction
/ko/docs/XPInstall_API_Reference:Install_Object	/docs/ko/XPInstall_API_Reference/Install_Object
/ko/docs/XPInstall_API_Reference:Install_Object:Properties	/docs/ko/XPInstall_API_Reference/Install_Object/Properties
/ko/docs/XPInstall_API_Reference:Return_Codes	/docs/ko/XPInstall_API_Reference/Return_Codes
/ko/docs/XPath	/ko/docs/Web/XPath
/ko/docs/XPath/Axes	/ko/docs/Web/XPath/Axes
/ko/docs/XPath/Axes/ancestor	/ko/docs/Web/XPath/Axes/ancestor
/ko/docs/XPath/Axes/ancestor-or-self	/ko/docs/Web/XPath/Axes/ancestor-or-self
/ko/docs/XPath/Axes/attribute	/ko/docs/Web/XPath/Axes/attribute
/ko/docs/XPath/Axes/child	/ko/docs/Web/XPath/Axes/child
/ko/docs/XPath/Axes/descendant	/ko/docs/Web/XPath/Axes/descendant
/ko/docs/XPath/Axes/descendant-or-self	/ko/docs/Web/XPath/Axes/descendant-or-self
/ko/docs/XPath/Axes/following	/ko/docs/Web/XPath/Axes/following
/ko/docs/XPath/Axes/following-sibling	/ko/docs/Web/XPath/Axes/following-sibling
/ko/docs/XPath/Axes/namespace	/ko/docs/Web/XPath/Axes/namespace
/ko/docs/XPath/Axes/parent	/ko/docs/Web/XPath/Axes/parent
/ko/docs/XPath/Axes/preceding	/ko/docs/Web/XPath/Axes/preceding
/ko/docs/XPath/Axes/preceding-sibling	/ko/docs/Web/XPath/Axes/preceding-sibling
/ko/docs/XPath/Axes/self	/ko/docs/Web/XPath/Axes/self
/ko/docs/XPath/Functions	/ko/docs/Web/XPath/Functions
/ko/docs/XPath/Functions/boolean	/ko/docs/Web/XPath/Functions/boolean
/ko/docs/XPath/Functions/ceiling	/ko/docs/Web/XPath/Functions/ceiling
/ko/docs/XPath/Functions/concat	/ko/docs/Web/XPath/Functions/concat
/ko/docs/XPath/Functions/contains	/ko/docs/Web/XPath/Functions/contains
/ko/docs/XPath/Functions/count	/ko/docs/Web/XPath/Functions/count
/ko/docs/XPath/Functions/current	/ko/docs/Web/XPath/Functions/current
/ko/docs/XPath/Functions/document	/ko/docs/Web/XPath/Functions/document
/ko/docs/XPath/Functions/element-available	/ko/docs/Web/XPath/Functions/element-available
/ko/docs/XPath/Functions/false	/ko/docs/Web/XPath/Functions/false
/ko/docs/XPath/Functions/floor	/ko/docs/Web/XPath/Functions/floor
/ko/docs/XPath/Functions/format-number	/ko/docs/Web/XPath/Functions/format-number
/ko/docs/XPath/Functions/function-available	/ko/docs/Web/XPath/Functions/function-available
/ko/docs/XPath/Functions/generate-id	/ko/docs/Web/XPath/Functions/generate-id
/ko/docs/XPath/Functions/id	/ko/docs/Web/XPath/Functions/id
/ko/docs/XPath/Functions/key	/ko/docs/Web/XPath/Functions/key
/ko/docs/XPath/Functions/lang	/ko/docs/Web/XPath/Functions/lang
/ko/docs/XPath/Functions/last	/ko/docs/Web/XPath/Functions/last
/ko/docs/XPath/Functions/local-name	/ko/docs/Web/XPath/Functions/local-name
/ko/docs/XPath/Functions/name	/ko/docs/Web/XPath/Functions/name
/ko/docs/XPath/Functions/namespace-uri	/ko/docs/Web/XPath/Functions/namespace-uri
/ko/docs/XPath/Functions/normalize-space	/ko/docs/Web/XPath/Functions/normalize-space
/ko/docs/XPath/Functions/not	/ko/docs/Web/XPath/Functions/not
/ko/docs/XPath/Functions/number	/ko/docs/Web/XPath/Functions/number
/ko/docs/XPath/Functions/position	/ko/docs/Web/XPath/Functions/position
/ko/docs/XPath/Functions/round	/ko/docs/Web/XPath/Functions/round
/ko/docs/XPath/Functions/starts-with	/ko/docs/Web/XPath/Functions/starts-with
/ko/docs/XPath/Functions/string	/ko/docs/Web/XPath/Functions/string
/ko/docs/XPath/Functions/string-length	/ko/docs/Web/XPath/Functions/string-length
/ko/docs/XPath/Functions/substring	/ko/docs/Web/XPath/Functions/substring
/ko/docs/XPath/Functions/substring-after	/ko/docs/Web/XPath/Functions/substring-after
/ko/docs/XPath/Functions/substring-before	/ko/docs/Web/XPath/Functions/substring-before
/ko/docs/XPath/Functions/sum	/ko/docs/Web/XPath/Functions/sum
/ko/docs/XPath/Functions/system-property	/ko/docs/Web/XPath/Functions/system-property
/ko/docs/XPath/Functions/translate	/ko/docs/Web/XPath/Functions/translate
/ko/docs/XPath/Functions/true	/ko/docs/Web/XPath/Functions/true
/ko/docs/XPath/Functions/unparsed-entity-url	/ko/docs/Web/XPath/Functions/unparsed-entity-url
/ko/docs/XPath:Axes	/docs/ko/XPath/Axes
/ko/docs/XPath:Axes:ancestor	/docs/ko/XPath/Axes/ancestor
/ko/docs/XPath:Axes:ancestor-or-self	/docs/ko/XPath/Axes/ancestor-or-self
/ko/docs/XPath:Axes:attribute	/docs/ko/XPath/Axes/attribute
/ko/docs/XPath:Axes:child	/docs/ko/XPath/Axes/child
/ko/docs/XPath:Axes:descendant	/docs/ko/XPath/Axes/descendant
/ko/docs/XPath:Axes:descendant-or-self	/docs/ko/XPath/Axes/descendant-or-self
/ko/docs/XPath:Axes:following	/docs/ko/XPath/Axes/following
/ko/docs/XPath:Axes:following-sibling	/docs/ko/XPath/Axes/following-sibling
/ko/docs/XPath:Axes:namespace	/docs/ko/XPath/Axes/namespace
/ko/docs/XPath:Axes:parent	/docs/ko/XPath/Axes/parent
/ko/docs/XPath:Axes:preceding	/docs/ko/XPath/Axes/preceding
/ko/docs/XPath:Axes:preceding-sibling	/docs/ko/XPath/Axes/preceding-sibling
/ko/docs/XPath:Axes:self	/docs/ko/XPath/Axes/self
/ko/docs/XPath:Functions	/docs/ko/XPath/Functions
/ko/docs/XPath:Functions:boolean	/docs/ko/XPath/Functions/boolean
/ko/docs/XPath:Functions:ceiling	/docs/ko/XPath/Functions/ceiling
/ko/docs/XPath:Functions:concat	/docs/ko/XPath/Functions/concat
/ko/docs/XPath:Functions:contains	/docs/ko/XPath/Functions/contains
/ko/docs/XPath:Functions:count	/docs/ko/XPath/Functions/count
/ko/docs/XPath:Functions:current	/docs/ko/XPath/Functions/current
/ko/docs/XPath:Functions:document	/docs/ko/XPath/Functions/document
/ko/docs/XPath:Functions:element-available	/docs/ko/XPath/Functions/element-available
/ko/docs/XPath:Functions:false	/docs/ko/XPath/Functions/false
/ko/docs/XPath:Functions:floor	/docs/ko/XPath/Functions/floor
/ko/docs/XPath:Functions:format-number	/docs/ko/XPath/Functions/format-number
/ko/docs/XPath:Functions:function-available	/docs/ko/XPath/Functions/function-available
/ko/docs/XPath:Functions:generate-id	/docs/ko/XPath/Functions/generate-id
/ko/docs/XPath:Functions:id	/docs/ko/XPath/Functions/id
/ko/docs/XPath:Functions:key	/docs/ko/XPath/Functions/key
/ko/docs/XPath:Functions:lang	/docs/ko/XPath/Functions/lang
/ko/docs/XPath:Functions:last	/docs/ko/XPath/Functions/last
/ko/docs/XPath:Functions:local-name	/docs/ko/XPath/Functions/local-name
/ko/docs/XPath:Functions:name	/docs/ko/XPath/Functions/name
/ko/docs/XPath:Functions:namespace-uri	/docs/ko/XPath/Functions/namespace-uri
/ko/docs/XPath:Functions:normalize-space	/docs/ko/XPath/Functions/normalize-space
/ko/docs/XPath:Functions:not	/docs/ko/XPath/Functions/not
/ko/docs/XPath:Functions:number	/docs/ko/XPath/Functions/number
/ko/docs/XPath:Functions:position	/docs/ko/XPath/Functions/position
/ko/docs/XPath:Functions:round	/docs/ko/XPath/Functions/round
/ko/docs/XPath:Functions:starts-with	/docs/ko/XPath/Functions/starts-with
/ko/docs/XPath:Functions:string	/docs/ko/XPath/Functions/string
/ko/docs/XPath:Functions:string-length	/docs/ko/XPath/Functions/string-length
/ko/docs/XPath:Functions:substring	/docs/ko/XPath/Functions/substring
/ko/docs/XPath:Functions:substring-after	/docs/ko/XPath/Functions/substring-after
/ko/docs/XPath:Functions:substring-before	/docs/ko/XPath/Functions/substring-before
/ko/docs/XPath:Functions:sum	/docs/ko/XPath/Functions/sum
/ko/docs/XPath:Functions:system-property	/docs/ko/XPath/Functions/system-property
/ko/docs/XPath:Functions:translate	/docs/ko/XPath/Functions/translate
/ko/docs/XPath:Functions:true	/docs/ko/XPath/Functions/true
/ko/docs/XPath:Functions:unparsed-entity-url	/docs/ko/XPath/Functions/unparsed-entity-url
/ko/docs/XSLT	/ko/docs/Web/XSLT
/ko/docs/XSLT/Elements	/ko/docs/Web/XSLT/Elements
/ko/docs/XSLT/apply-imports	/ko/docs/Web/XSLT/apply-imports
/ko/docs/XSLT/apply-templates	/ko/docs/Web/XSLT/apply-templates
/ko/docs/XSLT/attribute	/ko/docs/Web/XSLT/attribute
/ko/docs/XSLT/attribute-set	/ko/docs/Web/XSLT/attribute-set
/ko/docs/XSLT/call-template	/ko/docs/Web/XSLT/call-template
/ko/docs/XSLT/choose	/ko/docs/Web/XSLT/choose
/ko/docs/XSLT/comment	/ko/docs/Web/XSLT/comment
/ko/docs/XSLT/copy	/ko/docs/Web/XSLT/copy
/ko/docs/XSLT/copy-of	/ko/docs/Web/XSLT/copy-of
/ko/docs/XSLT/decimal-format	/ko/docs/Web/XSLT/decimal-format
/ko/docs/XSLT/element	/ko/docs/Web/XSLT/Element/element
/ko/docs/XSLT/fallback	/ko/docs/Web/XSLT/fallback
/ko/docs/XSLT/for-each	/ko/docs/Web/XSLT/for-each
/ko/docs/XSLT/if	/ko/docs/Web/XSLT/if
/ko/docs/XSLT/import	/ko/docs/Web/XSLT/import
/ko/docs/XSLT/include	/ko/docs/Web/XSLT/include
/ko/docs/XSLT/key	/ko/docs/Web/XSLT/key
/ko/docs/XSLT/message	/ko/docs/Web/XSLT/message
/ko/docs/XSLT/namespace-alias	/ko/docs/Web/XSLT/namespace-alias
/ko/docs/XSLT/number	/ko/docs/Web/XSLT/number
/ko/docs/XSLT/otherwise	/ko/docs/Web/XSLT/otherwise
/ko/docs/XSLT/output	/ko/docs/Web/XSLT/output
/ko/docs/XSLT/param	/ko/docs/Web/XSLT/param
/ko/docs/XSLT/preserve-space	/ko/docs/Web/XSLT/preserve-space
/ko/docs/XSLT/processing-instruction	/ko/docs/Web/XSLT/processing-instruction
/ko/docs/XSLT/sort	/ko/docs/Web/XSLT/sort
/ko/docs/XSLT/strip-space	/ko/docs/Web/XSLT/strip-space
/ko/docs/XSLT/stylesheet	/ko/docs/Web/XSLT/stylesheet
/ko/docs/XSLT/template	/ko/docs/Web/XSLT/template
/ko/docs/XSLT/text	/ko/docs/Web/XSLT/text
/ko/docs/XSLT/transform	/ko/docs/Web/XSLT/transform
/ko/docs/XSLT/value-of	/ko/docs/Web/XSLT/value-of
/ko/docs/XSLT/variable	/ko/docs/Web/XSLT/variable
/ko/docs/XSLT/when	/ko/docs/Web/XSLT/when
/ko/docs/XSLT/with-param	/ko/docs/Web/XSLT/with-param
/ko/docs/XSLT:Elements	/docs/ko/XSLT/Elements
/ko/docs/XSLT:apply-imports	/docs/ko/XSLT/apply-imports
/ko/docs/XSLT:apply-templates	/docs/ko/XSLT/apply-templates
/ko/docs/XSLT:attribute	/docs/ko/XSLT/attribute
/ko/docs/XSLT:attribute-set	/docs/ko/XSLT/attribute-set
/ko/docs/XSLT:call-template	/docs/ko/XSLT/call-template
/ko/docs/XSLT:choose	/docs/ko/XSLT/choose
/ko/docs/XSLT:comment	/docs/ko/XSLT/comment
/ko/docs/XSLT:copy	/docs/ko/XSLT/copy
/ko/docs/XSLT:copy-of	/docs/ko/XSLT/copy-of
/ko/docs/XSLT:decimal-format	/docs/ko/XSLT/decimal-format
/ko/docs/XSLT:element	/docs/ko/XSLT/element
/ko/docs/XSLT:fallback	/docs/ko/XSLT/fallback
/ko/docs/XSLT:for-each	/docs/ko/XSLT/for-each
/ko/docs/XSLT:if	/docs/ko/XSLT/if
/ko/docs/XSLT:import	/docs/ko/XSLT/import
/ko/docs/XSLT:include	/docs/ko/XSLT/include
/ko/docs/XSLT:key	/docs/ko/XSLT/key
/ko/docs/XSLT:message	/docs/ko/XSLT/message
/ko/docs/XSLT:namespace-alias	/docs/ko/XSLT/namespace-alias
/ko/docs/XSLT:number	/docs/ko/XSLT/number
/ko/docs/XSLT:otherwise	/docs/ko/XSLT/otherwise
/ko/docs/XSLT:output	/docs/ko/XSLT/output
/ko/docs/XSLT:param	/docs/ko/XSLT/param
/ko/docs/XSLT:preserve-space	/docs/ko/XSLT/preserve-space
/ko/docs/XSLT:processing-instruction	/docs/ko/XSLT/processing-instruction
/ko/docs/XSLT:sort	/docs/ko/XSLT/sort
/ko/docs/XSLT:strip-space	/docs/ko/XSLT/strip-space
/ko/docs/XSLT:stylesheet	/docs/ko/XSLT/stylesheet
/ko/docs/XSLT:template	/docs/ko/XSLT/template
/ko/docs/XSLT:text	/docs/ko/XSLT/text
/ko/docs/XSLT:transform	/docs/ko/XSLT/transform
/ko/docs/XSLT:value-of	/docs/ko/XSLT/value-of
/ko/docs/XSLT:variable	/docs/ko/XSLT/variable
/ko/docs/XSLT:when	/docs/ko/XSLT/when
/ko/docs/XSLT:with-param	/docs/ko/XSLT/with-param
/ko/docs/XSLT_in_Gecko:Basic_Example	/docs/ko/XSLT_in_Gecko/Basic_Example
/ko/docs/XSLT_in_Gecko:Browser_Differences	/docs/ko/XSLT_in_Gecko/Browser_Differences
/ko/docs/XSLT_in_Gecko:Generating_HTML	/docs/ko/XSLT_in_Gecko/Generating_HTML
/ko/docs/XSLT_in_Gecko:Introduction	/docs/ko/XSLT_in_Gecko/Introduction
/ko/docs/XSLT_in_Gecko:Resources	/docs/ko/XSLT_in_Gecko/Resources
/ko/docs/XTech_2005_Presentations:Directions_of_the_Mozilla_RDF_engine	/docs/ko/XTech_2005_Presentations/Directions_of_the_Mozilla_RDF_engine
/ko/docs/XUL	/ko/docs/Mozilla/Tech/XUL
/ko/docs/XUL/Attribute	/ko/docs/Mozilla/Tech/XUL/Attribute
/ko/docs/XUL/Attribute/accesskey	/ko/docs/Mozilla/Tech/XUL/Attribute/accesskey
/ko/docs/XUL/Attribute/currentset	/ko/docs/Mozilla/Tech/XUL/Attribute/currentset
/ko/docs/XUL/Property	/ko/docs/Mozilla/Tech/XUL/Property
/ko/docs/XUL/Template_Guide	/ko/docs/Mozilla/Tech/XUL/Template_Guide
/ko/docs/XUL/menu	/ko/docs/Mozilla/Tech/XUL/menu
/ko/docs/XUL/splitter	/ko/docs/Mozilla/Tech/XUL/splitter
/ko/docs/XUL/toolbar	/ko/docs/Mozilla/Tech/XUL/toolbar
/ko/docs/XUL/toolbarbutton	/ko/docs/Mozilla/Tech/XUL/toolbarbutton
/ko/docs/XUL/toolbarpalette	/ko/docs/Mozilla/Tech/XUL/toolbarpalette
/ko/docs/XUL:Attribute	/docs/ko/XUL/Attribute
/ko/docs/XUL:Attribute:accesskey	/docs/ko/XUL/Attribute/accesskey
/ko/docs/XUL:Attribute:currentset	/docs/ko/XUL/Attribute/currentset
/ko/docs/XUL:Property	/docs/ko/XUL/Property
/ko/docs/XUL:Template_Guide	/docs/ko/XUL/Template_Guide
/ko/docs/XUL:splitter	/docs/ko/XUL/splitter
/ko/docs/XUL:toolbar	/docs/ko/XUL/toolbar
/ko/docs/XUL:toolbarbutton	/docs/ko/XUL/toolbarbutton
/ko/docs/XUL:toolbarpalette	/docs/ko/XUL/toolbarpalette
/ko/docs/XULRunner	/ko/docs/Archive/Mozilla/XULRunner
/ko/docs/XULRunner/What_XULRunner_Provides	/ko/docs/Archive/Mozilla/XULRunner/What_XULRunner_Provides
/ko/docs/XULRunner:What_XULRunner_Provides	/docs/ko/XULRunner/What_XULRunner_Provides
/ko/docs/XULRunner_FAQ	/ko/docs/Archive/Mozilla/XULRunner/XULRunner_FAQ
/ko/docs/XULRunner_Hall_of_Fame	/ko/docs/Archive/Mozilla/XULRunner/XULRunner_Hall_of_Fame
/ko/docs/XULRunner_tips	/ko/docs/Archive/Mozilla/XULRunner/XULRunner_tips
/ko/docs/XUL_Application_Packaging	/ko/docs/Archive/Mozilla/XULRunner/XUL_Application_Packaging
/ko/docs/XUL_Reference	/ko/docs/Mozilla/Tech/XUL/XUL_Reference
/ko/docs/XUL_Tutorial	/ko/docs/Mozilla/Tech/XUL/XUL_Tutorial
/ko/docs/XUL_Tutorial/Adding_Buttons	/ko/docs/Mozilla/Tech/XUL/XUL_Tutorial/Adding_Buttons
/ko/docs/XUL_Tutorial/Adding_Event_Handlers	/ko/docs/Mozilla/Tech/XUL/XUL_Tutorial/Adding_Event_Handlers
/ko/docs/XUL_Tutorial/Adding_HTML_Elements	/ko/docs/Mozilla/Tech/XUL/XUL_Tutorial/Adding_HTML_Elements
/ko/docs/XUL_Tutorial/Adding_Labels_and_Images	/ko/docs/Mozilla/Tech/XUL/XUL_Tutorial/Adding_Labels_and_Images
/ko/docs/XUL_Tutorial/Adding_More_Elements	/ko/docs/Mozilla/Tech/XUL/XUL_Tutorial/Adding_More_Elements
/ko/docs/XUL_Tutorial/Box_Model_Details	/ko/docs/Mozilla/Tech/XUL/XUL_Tutorial/Box_Model_Details
/ko/docs/XUL_Tutorial/Content_Panels	/ko/docs/Mozilla/Tech/XUL/XUL_Tutorial/Content_Panels
/ko/docs/XUL_Tutorial/Creating_a_Window	/ko/docs/Mozilla/Tech/XUL/XUL_Tutorial/Creating_a_Window
/ko/docs/XUL_Tutorial/Cross_Package_Overlays	/ko/docs/Mozilla/Tech/XUL/XUL_Tutorial/Cross_Package_Overlays
/ko/docs/XUL_Tutorial/Element_Positioning	/ko/docs/Mozilla/Tech/XUL/XUL_Tutorial/Element_Positioning
/ko/docs/XUL_Tutorial/Focus_and_Selection	/ko/docs/Mozilla/Tech/XUL/XUL_Tutorial/Focus_and_Selection
/ko/docs/XUL_Tutorial/Grids	/ko/docs/Mozilla/Tech/XUL/XUL_Tutorial/Grids
/ko/docs/XUL_Tutorial/Groupboxes	/ko/docs/Mozilla/Tech/XUL/XUL_Tutorial/Groupboxes
/ko/docs/XUL_Tutorial/Input_Controls	/ko/docs/Mozilla/Tech/XUL/XUL_Tutorial/Input_Controls
/ko/docs/XUL_Tutorial/Introduction	/ko/docs/Mozilla/Tech/XUL/XUL_Tutorial/Introduction
/ko/docs/XUL_Tutorial/Introduction_to_RDF	/ko/docs/Mozilla/Tech/XUL/XUL_Tutorial/Introduction_to_RDF
/ko/docs/XUL_Tutorial/Introduction_to_XBL	/ko/docs/Mozilla/Tech/XUL/XUL_Tutorial/Introduction_to_XBL
/ko/docs/XUL_Tutorial/Keyboard_Shortcuts	/ko/docs/Mozilla/Tech/XUL/XUL_Tutorial/Keyboard_Shortcuts
/ko/docs/XUL_Tutorial/List_Controls	/ko/docs/Mozilla/Tech/XUL/XUL_Tutorial/List_Controls
/ko/docs/XUL_Tutorial/Localization	/ko/docs/Mozilla/Tech/XUL/XUL_Tutorial/Localization
/ko/docs/XUL_Tutorial/Manifest_Files	/ko/docs/Mozilla/Tech/XUL/XUL_Tutorial/Manifest_Files
/ko/docs/XUL_Tutorial/More_Button_Features	/ko/docs/Mozilla/Tech/XUL/XUL_Tutorial/More_Button_Features
/ko/docs/XUL_Tutorial/More_Event_Handlers	/ko/docs/Mozilla/Tech/XUL/XUL_Tutorial/More_Event_Handlers
/ko/docs/XUL_Tutorial/More_Menu_Features	/ko/docs/Mozilla/Tech/XUL/XUL_Tutorial/More_Menu_Features
/ko/docs/XUL_Tutorial/Overlays	/ko/docs/Mozilla/Tech/XUL/XUL_Tutorial/Overlays
/ko/docs/XUL_Tutorial/Popup_Menus	/ko/docs/Mozilla/Tech/XUL/XUL_Tutorial/Popup_Menus
/ko/docs/XUL_Tutorial/Progress_Meters	/ko/docs/Mozilla/Tech/XUL/XUL_Tutorial/Progress_Meters
/ko/docs/XUL_Tutorial/Property_Files	/ko/docs/Mozilla/Tech/XUL/XUL_Tutorial/Property_Files
/ko/docs/XUL_Tutorial/Scroll_Bars	/ko/docs/Mozilla/Tech/XUL/XUL_Tutorial/Scroll_Bars
/ko/docs/XUL_Tutorial/Scrolling_Menus	/ko/docs/Mozilla/Tech/XUL/XUL_Tutorial/Scrolling_Menus
/ko/docs/XUL_Tutorial/Simple_Menu_Bars	/ko/docs/Mozilla/Tech/XUL/XUL_Tutorial/Simple_Menu_Bars
/ko/docs/XUL_Tutorial/Splitters	/ko/docs/Mozilla/Tech/XUL/XUL_Tutorial/Splitters
/ko/docs/XUL_Tutorial/Stack_Positioning	/ko/docs/Mozilla/Tech/XUL/XUL_Tutorial/Stack_Positioning
/ko/docs/XUL_Tutorial/Stacks_and_Decks	/ko/docs/Mozilla/Tech/XUL/XUL_Tutorial/Stacks_and_Decks
/ko/docs/XUL_Tutorial/Tabboxes	/ko/docs/Mozilla/Tech/XUL/XUL_Tutorial/Tabboxes
/ko/docs/XUL_Tutorial/Templates	/ko/docs/Mozilla/Tech/XUL/XUL_Tutorial/Templates
/ko/docs/XUL_Tutorial/The_Box_Model	/ko/docs/Mozilla/Tech/XUL/XUL_Tutorial/The_Box_Model
/ko/docs/XUL_Tutorial/The_Chrome_URL	/ko/docs/Mozilla/Tech/XUL/XUL_Tutorial/The_Chrome_URL
/ko/docs/XUL_Tutorial/Toolbars	/ko/docs/Mozilla/Tech/XUL/XUL_Tutorial/Toolbars
/ko/docs/XUL_Tutorial/Trees	/ko/docs/Mozilla/Tech/XUL/XUL_Tutorial/Trees
/ko/docs/XUL_Tutorial/Using_Spacers	/ko/docs/Mozilla/Tech/XUL/XUL_Tutorial/Using_Spacers
/ko/docs/XUL_Tutorial/XPCOM_Examples	/ko/docs/Mozilla/Tech/XUL/XUL_Tutorial/XPCOM_Examples
/ko/docs/XUL_Tutorial/XPCOM_Interfaces	/ko/docs/Mozilla/Tech/XUL/XUL_Tutorial/XPCOM_Interfaces
/ko/docs/XUL_Tutorial/XUL_Structure	/ko/docs/Mozilla/Tech/XUL/XUL_Tutorial/XUL_Structure
/ko/docs/XUL_Tutorial:Adding_Buttons	/docs/ko/XUL_Tutorial/Adding_Buttons
/ko/docs/XUL_Tutorial:Adding_Event_Handlers	/docs/ko/XUL_Tutorial/Adding_Event_Handlers
/ko/docs/XUL_Tutorial:Adding_HTML_Elements	/docs/ko/XUL_Tutorial/Adding_HTML_Elements
/ko/docs/XUL_Tutorial:Adding_Labels_and_Images	/docs/ko/XUL_Tutorial/Adding_Labels_and_Images
/ko/docs/XUL_Tutorial:Adding_More_Elements	/docs/ko/XUL_Tutorial/Adding_More_Elements
/ko/docs/XUL_Tutorial:Box_Model_Details	/docs/ko/XUL_Tutorial/Box_Model_Details
/ko/docs/XUL_Tutorial:Content_Panels	/docs/ko/XUL_Tutorial/Content_Panels
/ko/docs/XUL_Tutorial:Creating_a_Window	/docs/ko/XUL_Tutorial/Creating_a_Window
/ko/docs/XUL_Tutorial:Cross_Package_Overlays	/docs/ko/XUL_Tutorial/Cross_Package_Overlays
/ko/docs/XUL_Tutorial:Element_Positioning	/docs/ko/XUL_Tutorial/Element_Positioning
/ko/docs/XUL_Tutorial:Focus_and_Selection	/docs/ko/XUL_Tutorial/Focus_and_Selection
/ko/docs/XUL_Tutorial:Grids	/docs/ko/XUL_Tutorial/Grids
/ko/docs/XUL_Tutorial:Groupboxes	/docs/ko/XUL_Tutorial/Groupboxes
/ko/docs/XUL_Tutorial:Input_Controls	/docs/ko/XUL_Tutorial/Input_Controls
/ko/docs/XUL_Tutorial:Introduction	/docs/ko/XUL_Tutorial/Introduction
/ko/docs/XUL_Tutorial:Introduction_to_RDF	/docs/ko/XUL_Tutorial/Introduction_to_RDF
/ko/docs/XUL_Tutorial:Introduction_to_XBL	/docs/ko/XUL_Tutorial/Introduction_to_XBL
/ko/docs/XUL_Tutorial:Keyboard_Shortcuts	/docs/ko/XUL_Tutorial/Keyboard_Shortcuts
/ko/docs/XUL_Tutorial:List_Controls	/docs/ko/XUL_Tutorial/List_Controls
/ko/docs/XUL_Tutorial:Localization	/docs/ko/XUL_Tutorial/Localization
/ko/docs/XUL_Tutorial:Manifest_Files	/docs/ko/XUL_Tutorial/Manifest_Files
/ko/docs/XUL_Tutorial:More_Button_Features	/docs/ko/XUL_Tutorial/More_Button_Features
/ko/docs/XUL_Tutorial:More_Event_Handlers	/docs/ko/XUL_Tutorial/More_Event_Handlers
/ko/docs/XUL_Tutorial:More_Menu_Features	/docs/ko/XUL_Tutorial/More_Menu_Features
/ko/docs/XUL_Tutorial:Overlays	/docs/ko/XUL_Tutorial/Overlays
/ko/docs/XUL_Tutorial:Popup_Menus	/docs/ko/XUL_Tutorial/Popup_Menus
/ko/docs/XUL_Tutorial:Progress_Meters	/docs/ko/XUL_Tutorial/Progress_Meters
/ko/docs/XUL_Tutorial:Property_Files	/docs/ko/XUL_Tutorial/Property_Files
/ko/docs/XUL_Tutorial:Scroll_Bars	/docs/ko/XUL_Tutorial/Scroll_Bars
/ko/docs/XUL_Tutorial:Scrolling_Menus	/docs/ko/XUL_Tutorial/Scrolling_Menus
/ko/docs/XUL_Tutorial:Simple_Menu_Bars	/docs/ko/XUL_Tutorial/Simple_Menu_Bars
/ko/docs/XUL_Tutorial:Splitters	/docs/ko/XUL_Tutorial/Splitters
/ko/docs/XUL_Tutorial:Stack_Positioning	/docs/ko/XUL_Tutorial/Stack_Positioning
/ko/docs/XUL_Tutorial:Stacks_and_Decks	/docs/ko/XUL_Tutorial/Stacks_and_Decks
/ko/docs/XUL_Tutorial:Tabboxes	/docs/ko/XUL_Tutorial/Tabboxes
/ko/docs/XUL_Tutorial:Templates	/docs/ko/XUL_Tutorial/Templates
/ko/docs/XUL_Tutorial:The_Box_Model	/docs/ko/XUL_Tutorial/The_Box_Model
/ko/docs/XUL_Tutorial:The_Chrome_URL	/docs/ko/XUL_Tutorial/The_Chrome_URL
/ko/docs/XUL_Tutorial:Toolbars	/docs/ko/XUL_Tutorial/Toolbars
/ko/docs/XUL_Tutorial:Trees	/docs/ko/XUL_Tutorial/Trees
/ko/docs/XUL_Tutorial:Using_Spacers	/docs/ko/XUL_Tutorial/Using_Spacers
/ko/docs/XUL_Tutorial:XPCOM_Examples	/docs/ko/XUL_Tutorial/XPCOM_Examples
/ko/docs/XUL_Tutorial:XPCOM_Interfaces	/docs/ko/XUL_Tutorial/XPCOM_Interfaces
/ko/docs/XUL_Tutorial:XUL_Structure	/docs/ko/XUL_Tutorial/XUL_Structure
/ko/docs/XUL_controls	/ko/docs/Mozilla/Tech/XUL/XUL_controls
/ko/docs/XUL_레퍼런스	/docs/ko/XUL_Reference
/ko/docs/en	/
/ko/docs/대문	/docs/ko
/ko/docs/도구들/Firefox_OS_Simulator	/ko/docs/Archive/B2G_OS/Simulator
/ko/docs/호환_모드와_표준_모드	/ko/docs/Web/HTML/Quirks_Mode_and_Standards_Mode
