# FROM-URL	TO-URL
/de/docs/AJAX	/de/docs/Web/Guide/AJAX
/de/docs/AJAX/Getting_Started	/de/docs/Web/Guide/AJAX/Getting_Started
/de/docs/AJAX:Getting_Started	/docs/de/AJAX/Getting_Started
/de/docs/Apps/FAQs/Marketplace	/de/Marketplace/FAQ
/de/docs/Apps/Progressiv	/de/docs/Web/Progressive_web_apps
/de/docs/Apps/Progressiv/Introduction	/de/docs/Web/Progressive_web_apps/Introduction
/de/docs/Apps/Publishing/Marketplace_review_criteria	/de/Marketplace/Submission/Marketplace_review_criteria
/de/docs/Apps/Publishing/Submitting_an_app	/de/Marketplace/Submission/Submitting_an_app
/de/docs/Archive/B2G_OS/Developer_phone_guide	/de/docs/Archive/B2G_OS/Phone_guide
/de/docs/Archive/B2G_OS/Developer_phone_guide/Alcatel_One_Touch_Fire	/de/docs/Archive/B2G_OS/Phone_guide/Alcatel_One_Touch_Fire
/de/docs/Archive/B2G_OS/Developer_phone_guide/Flame	/de/docs/Archive/B2G_OS/Phone_guide/Flame
/de/docs/Archive/B2G_OS/Developer_phone_guide/Geeksphone	/de/docs/Archive/B2G_OS/Phone_guide/Geeksphone
/de/docs/Archive/B2G_OS/Developer_phone_guide/Phone_specs	/de/docs/Archive/B2G_OS/Phone_guide/Phone_specs
/de/docs/Archive/B2G_OS/Developer_phone_guide/ZTE_OPEN_C	/de/docs/Archive/B2G_OS/Phone_guide/ZTE_OPEN_C
/de/docs/Archive/B2G_OS/Einführung	/de/docs/Archive/B2G_OS/Introduction
/de/docs/Archive/B2G_OS/Hacking_Firefox_OS	/de/docs/Archive/B2G_OS/Developing_Firefox_OS
/de/docs/Archive/B2G_OS/Hacking_Firefox_OS/Filing_bugs_against_Firefox_OS	/de/docs/Archive/B2G_OS/Developing_Firefox_OS/Filing_bugs_against_Firefox_OS
/de/docs/Archive/Mozilla/Marketplace/Options	/en-US/Marketplace/Options/Introduction
/de/docs/Archive/Mozilla/XUL/Property	/docs/de/XUL/Eigenschaften
/de/docs/Archive/Mozilla/XUL/XUL_Tutorial/Die_Chrome-URL	/de/docs/Mozilla/Tech/XUL/XUL_Tutorial/Die_Chrome_URL
/de/docs/Barrierefreiheit	/de/docs/Web/Barrierefreiheit
/de/docs/Barrierefreiheit/ARIA	/de/docs/Web/Barrierefreiheit/ARIA
/de/docs/Barrierefreiheit/ARIA/ARIA_Live_Regionen	/de/docs/Web/Barrierefreiheit/ARIA/ARIA_Live_Regionen
/de/docs/Barrierefreiheit/An_overview_of_accessible_web_applications_and_widgets	/de/docs/Web/Barrierefreiheit/An_overview_of_accessible_web_applications_and_widgets
/de/docs/Barrierefreiheit/Webentwicklung	/de/docs/Web/Barrierefreiheit/Webentwicklung
/de/docs/BrowserID	/en-US/docs/Persona
/de/docs/Bug-Entdecken_Leitfaden	/docs/de/Richtlinien_zum_Schreiben_eines_Bugreports
/de/docs/Building_an_Extension	/docs/de/Erweiterung_erstellen
/de/docs/CSS	/de/docs/Web/CSS
/de/docs/CSS/-moz-border-radius	/de/docs/Web/CSS/-moz-border-radius
/de/docs/CSS/-moz-border-radius-bottomleft	/de/docs/Web/CSS/-moz-border-radius-bottomleft
/de/docs/CSS/-moz-border-radius-bottomright	/de/docs/Web/CSS/-moz-border-radius-bottomright
/de/docs/CSS/-moz-border-radius-topleft	/de/docs/Web/CSS/-moz-border-radius-topleft
/de/docs/CSS/-moz-border-radius-topright	/de/docs/Web/CSS/-moz-border-radius-topright
/de/docs/CSS/-moz-box-shadow	/de/docs/Web/CSS/-moz-box-shadow
/de/docs/CSS/-moz-image-region	/de/docs/Web/CSS/-moz-image-region
/de/docs/CSS/-moz-user-input	/de/docs/Web/CSS/-moz-user-input
/de/docs/CSS/-moz-user-modify	/de/docs/Web/CSS/-moz-user-modify
/de/docs/CSS/-moz-user-select	/de/docs/Web/CSS/-moz-user-select
/de/docs/CSS/:empty	/de/docs/Web/CSS/:empty
/de/docs/CSS/:lang	/de/docs/Web/CSS/:lang
/de/docs/CSS/@import	/de/docs/Web/CSS/@import
/de/docs/CSS/Attributselektoren	/de/docs/Web/CSS/Attributselektoren
/de/docs/CSS/Border-bottom-width	/de/docs/Web/CSS/Border-bottom-width
/de/docs/CSS/Border-left-width	/de/docs/Web/CSS/Border-left-width
/de/docs/CSS/Border-right-width	/de/docs/Web/CSS/Border-right-width
/de/docs/CSS/Border-top-width	/de/docs/Web/CSS/Border-top-width
/de/docs/CSS/Bottom	/de/docs/Web/CSS/Bottom
/de/docs/CSS/Boxmodell	/de/docs/Web/CSS/Boxmodell
/de/docs/CSS/CSS_Reference/Property_Template	/de/docs/Web/CSS/Property_Template
/de/docs/CSS/CSS_Unterstützung	/de/docs/Web/CSS/CSS_Unterst%C3%BCtzung
/de/docs/CSS/CSS_Werte_Geltung	/de/docs/Web/CSS/CSS_Werte_Geltung
/de/docs/CSS/CSS_animated_properties	/de/docs/CSS/CSS_animierbare_Eigenschaften
/de/docs/CSS/CSS_animierbare_Eigenschaften	/de/docs/Web/CSS/CSS_animierbare_Eigenschaften
/de/docs/CSS/CSS_prozentuale_werte	/de/docs/Web/CSS/CSS_prozentuale_werte
/de/docs/CSS/CSS_werte_syntax	/de/docs/Web/CSS/CSS_werte_syntax
/de/docs/CSS/Einführung	/de/docs/CSS/Getting_Started
/de/docs/CSS/Einheiten	/de/docs/Web/CSS/Einheiten
/de/docs/CSS/Farben	/de/docs/Web/CSS/Farben
/de/docs/CSS/Getting_Started	/de/docs/Web/CSS/Getting_Started
/de/docs/CSS/Getting_Started-weiterleitung-1	/de/docs/CSS/Getting_Started
/de/docs/CSS/Initialwert	/de/docs/Web/CSS/Initialwert
/de/docs/CSS/Left	/de/docs/Web/CSS/Left
/de/docs/CSS/Right	/de/docs/Web/CSS/Right
/de/docs/CSS/Top	/de/docs/Web/CSS/Top
/de/docs/CSS/Vererbung	/de/docs/Web/CSS/Vererbung
/de/docs/CSS/Vorlage	/de/docs/CSS/CSS_Reference/Property_Template
/de/docs/CSS/Wertdefinitionssyntax	/de/docs/Web/CSS/Wertdefinitionssyntax
/de/docs/CSS/azimuth	/de/docs/Web/CSS/azimuth
/de/docs/CSS/background	/de/docs/Web/CSS/background
/de/docs/CSS/background-attachment	/de/docs/Web/CSS/background-attachment
/de/docs/CSS/background-clip	/de/docs/Web/CSS/background-clip
/de/docs/CSS/background-color	/de/docs/Web/CSS/background-color
/de/docs/CSS/background-image	/de/docs/Web/CSS/background-image
/de/docs/CSS/background-origin	/de/docs/Web/CSS/background-origin
/de/docs/CSS/background-position	/de/docs/Web/CSS/background-position
/de/docs/CSS/background-repeat	/de/docs/Web/CSS/background-repeat
/de/docs/CSS/background-size	/de/docs/Web/CSS/background-size
/de/docs/CSS/berechneter_Wert	/de/docs/Web/CSS/berechneter_Wert
/de/docs/CSS/border	/de/docs/Web/CSS/border
/de/docs/CSS/border-bottom	/de/docs/Web/CSS/border-bottom
/de/docs/CSS/border-bottom-color	/de/docs/Web/CSS/border-bottom-color
/de/docs/CSS/border-bottom-left-radius	/de/docs/Web/CSS/border-bottom-left-radius
/de/docs/CSS/border-bottom-right-radius	/de/docs/Web/CSS/border-bottom-right-radius
/de/docs/CSS/border-bottom-style	/de/docs/Web/CSS/border-bottom-style
/de/docs/CSS/border-collapse	/de/docs/Web/CSS/border-collapse
/de/docs/CSS/border-color	/de/docs/Web/CSS/border-color
/de/docs/CSS/border-left	/de/docs/Web/CSS/border-left
/de/docs/CSS/border-left-color	/de/docs/Web/CSS/border-left-color
/de/docs/CSS/border-left-style	/de/docs/Web/CSS/border-left-style
/de/docs/CSS/border-radius	/de/docs/Web/CSS/border-radius
/de/docs/CSS/border-right	/de/docs/Web/CSS/border-right
/de/docs/CSS/border-right-color	/de/docs/Web/CSS/border-right-color
/de/docs/CSS/border-right-style	/de/docs/Web/CSS/border-right-style
/de/docs/CSS/border-spacing	/de/docs/Web/CSS/border-spacing
/de/docs/CSS/border-style	/de/docs/Web/CSS/border-style
/de/docs/CSS/border-top	/de/docs/Web/CSS/border-top
/de/docs/CSS/border-top-color	/de/docs/Web/CSS/border-top-color
/de/docs/CSS/border-top-left-radius	/de/docs/Web/CSS/border-top-left-radius
/de/docs/CSS/border-top-right-radius	/de/docs/Web/CSS/border-top-right-radius
/de/docs/CSS/border-top-style	/de/docs/Web/CSS/border-top-style
/de/docs/CSS/border-width	/de/docs/Web/CSS/border-width
/de/docs/CSS/box-shadow	/de/docs/Web/CSS/box-shadow
/de/docs/CSS/box-sizing	/de/docs/Web/CSS/box-sizing
/de/docs/CSS/calc	/de/docs/Web/CSS/calc
/de/docs/CSS/clear	/de/docs/Web/CSS/clear
/de/docs/CSS/color	/de/docs/Web/CSS/color
/de/docs/CSS/cursor	/de/docs/Web/CSS/cursor
/de/docs/CSS/display	/de/docs/Web/CSS/display
/de/docs/CSS/empty-cells	/de/docs/Web/CSS/empty-cells
/de/docs/CSS/float	/de/docs/Web/CSS/float
/de/docs/CSS/font	/de/docs/Web/CSS/font
/de/docs/CSS/height	/de/docs/Web/CSS/height
/de/docs/CSS/hyphens	/de/docs/Web/CSS/hyphens
/de/docs/CSS/laenge	/de/docs/Web/CSS/laenge
/de/docs/CSS/list-style	/de/docs/Web/CSS/list-style
/de/docs/CSS/margin	/de/docs/Web/CSS/margin
/de/docs/CSS/margin-bottom	/de/docs/Web/CSS/margin-bottom
/de/docs/CSS/margin-left	/de/docs/Web/CSS/margin-left
/de/docs/CSS/margin-right	/de/docs/Web/CSS/margin-right
/de/docs/CSS/margin-top	/de/docs/Web/CSS/margin-top
/de/docs/CSS/max-height	/de/docs/Web/CSS/max-height
/de/docs/CSS/max-width	/de/docs/Web/CSS/max-width
/de/docs/CSS/min-height	/de/docs/Web/CSS/min-height
/de/docs/CSS/min-width	/de/docs/Web/CSS/min-width
/de/docs/CSS/opacity	/de/docs/Web/CSS/opacity
/de/docs/CSS/overflow	/de/docs/Web/CSS/overflow
/de/docs/CSS/padding	/de/docs/Web/CSS/padding
/de/docs/CSS/padding-bottom	/de/docs/Web/CSS/padding-bottom
/de/docs/CSS/padding-left	/de/docs/Web/CSS/padding-left
/de/docs/CSS/padding-right	/de/docs/Web/CSS/padding-right
/de/docs/CSS/padding-top	/de/docs/Web/CSS/padding-top
/de/docs/CSS/page-break-after	/de/docs/Web/CSS/page-break-after
/de/docs/CSS/page-break-before	/de/docs/Web/CSS/page-break-before
/de/docs/CSS/page-break-inside	/de/docs/Web/CSS/page-break-inside
/de/docs/CSS/position	/de/docs/Web/CSS/position
/de/docs/CSS/resize	/de/docs/Web/CSS/resize
/de/docs/CSS/text-align	/de/docs/Web/CSS/text-align
/de/docs/CSS/text-decoration	/de/docs/Web/CSS/text-decoration
/de/docs/CSS/text-decoration-color	/de/docs/Web/CSS/text-decoration-color
/de/docs/CSS/text-shadow	/de/docs/Web/CSS/text-shadow
/de/docs/CSS/text-shadow/text-shadow	/de/docs/Web/CSS/text-shadow/text-shadow
/de/docs/CSS/time	/de/docs/Web/CSS/time
/de/docs/CSS/vertical-align	/de/docs/Web/CSS/vertical-align
/de/docs/CSS/visibility	/de/docs/Web/CSS/visibility
/de/docs/CSS/width	/de/docs/Web/CSS/width
/de/docs/CSS/xx	/de/docs/Web/CSS/xx
/de/docs/CSS:-moz-border-radius	/docs/de/CSS/-moz-border-radius
/de/docs/CSS:-moz-border-radius-bottomleft	/docs/de/CSS/-moz-border-radius-bottomleft
/de/docs/CSS:-moz-border-radius-bottomright	/docs/de/CSS/-moz-border-radius-bottomright
/de/docs/CSS:-moz-border-radius-topleft	/docs/de/CSS/-moz-border-radius-topleft
/de/docs/CSS:-moz-border-radius-topright	/docs/de/CSS/-moz-border-radius-topright
/de/docs/CSS:-moz-user-input	/docs/de/CSS/-moz-user-input
/de/docs/CSS:-moz-user-modify	/docs/de/CSS/-moz-user-modify
/de/docs/CSS:-moz-user-select	/docs/de/CSS/-moz-user-select
/de/docs/CSS::empty	/docs/de/CSS/:empty
/de/docs/CSS::lang	/docs/de/CSS/:lang
/de/docs/CSS:@import	/docs/de/CSS/@import
/de/docs/CSS:Boxmodell	/docs/de/CSS/Boxmodell
/de/docs/CSS:Einheiten	/docs/de/CSS/Einheiten
/de/docs/CSS:Farben	/docs/de/CSS/Farben
/de/docs/CSS:Vorlage	/docs/de/CSS/Vorlage
/de/docs/CSS:azimuth	/docs/de/CSS/azimuth
/de/docs/CSS:background	/docs/de/CSS/background
/de/docs/CSS:background-attachment	/docs/de/CSS/background-attachment
/de/docs/CSS:background-color	/docs/de/CSS/background-color
/de/docs/CSS:background-image	/docs/de/CSS/background-image
/de/docs/CSS:background-position	/docs/de/CSS/background-position
/de/docs/CSS:background-repeat	/docs/de/CSS/background-repeat
/de/docs/CSS:border	/docs/de/CSS/border
/de/docs/CSS:border-bottom	/docs/de/CSS/border-bottom
/de/docs/CSS:border-bottom-color	/docs/de/CSS/border-bottom-color
/de/docs/CSS:border-bottom-style	/docs/de/CSS/border-bottom-style
/de/docs/CSS:border-collapse	/docs/de/CSS/border-collapse
/de/docs/CSS:border-color	/docs/de/CSS/border-color
/de/docs/CSS:border-left	/docs/de/CSS/border-left
/de/docs/CSS:border-left-color	/docs/de/CSS/border-left-color
/de/docs/CSS:border-left-style	/docs/de/CSS/border-left-style
/de/docs/CSS:border-right	/docs/de/CSS/border-right
/de/docs/CSS:border-right-color	/docs/de/CSS/border-right-color
/de/docs/CSS:border-right-style	/docs/de/CSS/border-right-style
/de/docs/CSS:border-spacing	/docs/de/CSS/border-spacing
/de/docs/CSS:border-style	/docs/de/CSS/border-style
/de/docs/CSS:border-top	/docs/de/CSS/border-top
/de/docs/CSS:border-top-color	/docs/de/CSS/border-top-color
/de/docs/CSS:border-top-style	/docs/de/CSS/border-top-style
/de/docs/CSS:border-width	/docs/de/CSS/border-width
/de/docs/CSS:clear	/docs/de/CSS/clear
/de/docs/CSS:color	/docs/de/CSS/color
/de/docs/CSS:cue	/docs/de/CSS/cue
/de/docs/CSS:cue-after	/docs/de/CSS/cue-after
/de/docs/CSS:cue-before	/docs/de/CSS/cue-before
/de/docs/CSS:cursor	/docs/de/CSS/cursor
/de/docs/CSS:display	/docs/de/CSS/display
/de/docs/CSS:empty-cells	/docs/de/CSS/empty-cells
/de/docs/CSS:float	/docs/de/CSS/float
/de/docs/CSS:font	/docs/de/CSS/font
/de/docs/CSS:height	/docs/de/CSS/height
/de/docs/CSS:laenge	/docs/de/CSS/laenge
/de/docs/CSS:list-style	/docs/de/CSS/list-style
/de/docs/CSS:margin	/docs/de/CSS/margin
/de/docs/CSS:margin-bottom	/docs/de/CSS/margin-bottom
/de/docs/CSS:margin-left	/docs/de/CSS/margin-left
/de/docs/CSS:margin-right	/docs/de/CSS/margin-right
/de/docs/CSS:margin-top	/docs/de/CSS/margin-top
/de/docs/CSS:max-height	/docs/de/CSS/max-height
/de/docs/CSS:max-width	/docs/de/CSS/max-width
/de/docs/CSS:min-height	/docs/de/CSS/min-height
/de/docs/CSS:min-width	/docs/de/CSS/min-width
/de/docs/CSS:opacity	/docs/de/CSS/opacity
/de/docs/CSS:overflow	/docs/de/CSS/overflow
/de/docs/CSS:padding	/docs/de/CSS/padding
/de/docs/CSS:padding-bottom	/docs/de/CSS/padding-bottom
/de/docs/CSS:padding-left	/docs/de/CSS/padding-left
/de/docs/CSS:padding-right	/docs/de/CSS/padding-right
/de/docs/CSS:padding-top	/docs/de/CSS/padding-top
/de/docs/CSS:page-break-after	/docs/de/CSS/page-break-after
/de/docs/CSS:page-break-before	/docs/de/CSS/page-break-before
/de/docs/CSS:page-break-inside	/docs/de/CSS/page-break-inside
/de/docs/CSS:pause	/docs/de/CSS/pause
/de/docs/CSS:pause-after	/docs/de/CSS/pause-after
/de/docs/CSS:pause-before	/docs/de/CSS/pause-before
/de/docs/CSS:play-during	/docs/de/CSS/play-during
/de/docs/CSS:position	/docs/de/CSS/position
/de/docs/CSS:speak	/docs/de/CSS/speak
/de/docs/CSS:speak-header	/docs/de/CSS/speak-header
/de/docs/CSS:speak-numeral	/docs/de/CSS/speak-numeral
/de/docs/CSS:speak-punctuation	/docs/de/CSS/speak-punctuation
/de/docs/CSS:text-align	/docs/de/CSS/text-align
/de/docs/CSS:text-decoration	/docs/de/CSS/text-decoration
/de/docs/CSS:vertical-align	/docs/de/CSS/vertical-align
/de/docs/CSS:visibility	/docs/de/CSS/visibility
/de/docs/CSS:volume	/docs/de/CSS/volume
/de/docs/CSS:width	/docs/de/CSS/width
/de/docs/CSS_Referenz	/de/docs/Web/CSS/CSS_Referenz
/de/docs/CSS_Referenz/Mozilla_CSS_Erweiterungen	/de/docs/Web/CSS/CSS_Referenz/Mozilla_CSS_Erweiterungen
/de/docs/CSS_in_HTML_einbinden	/de/docs/Web/CSS/@import
/de/docs/Code_snippets	/de/docs/Codeschnipsel
/de/docs/Code_snippets/Scrollbar	/docs/de/Codeschnipsel/Scrollbar
/de/docs/Code_snippets/Windows	/docs/de/Codeschnipsel/Windows
/de/docs/Code_snippets:Tree	/docs/de/Code_snippets/Tree
/de/docs/Creating_a_Skin_for_Firefox	/de/docs/Theme_erstellen
/de/docs/Creating_a_Skin_for_Firefox/contents.rdf	/de/docs/Theme_erstellen/contents.rdf
/de/docs/Creating_a_Skin_for_Firefox/install.rdf	/de/docs/Theme_erstellen/install.rdf
/de/docs/Creating_a_Skin_for_Firefox:contents.rdf	/docs/de/Creating_a_Skin_for_Firefox/contents.rdf
/de/docs/Creating_a_Skin_for_Firefox:install.rdf	/docs/de/Creating_a_Skin_for_Firefox/install.rdf
/de/docs/DOM/File.fileName	/de/docs/Web/API/File/fileName
/de/docs/DOM/File.fileSize	/de/docs/Web/API/File/fileSize
/de/docs/DOM/File.getAsText	/de/docs/Web/API/File/getAsText
/de/docs/DOM/File.lastModifiedDate	/de/docs/Web/API/File/lastModifiedDate
/de/docs/DOM/File.name	/de/docs/Web/API/File/name
/de/docs/DOM/File.size	/de/docs/Web/API/File/size
/de/docs/DOM/File.type	/de/docs/Web/API/File/type
/de/docs/DOM/Node	/de/docs/Web/API/Node
/de/docs/DOM/Node.childNodes	/de/docs/Web/API/Node/childNodes
/de/docs/DOM/Node.firstChild	/de/docs/Web/API/Node/firstChild
/de/docs/DOM/Node.lastChild	/de/docs/Web/API/Node/lastChild
/de/docs/DOM/Node.nextSibling	/de/docs/Web/API/Node/nextSibling
/de/docs/DOM/Node.parentNode	/de/docs/Web/API/Node/parentNode
/de/docs/DOM/Node.previousSibling	/de/docs/Web/API/Node/previousSibling
/de/docs/DOM/Node.replaceChild	/de/docs/Web/API/Node/replaceChild
/de/docs/DOM/Node.textContent	/de/docs/Web/API/Node/textContent
/de/docs/DOM/XMLHttpRequest	/de/docs/Web/API/XMLHttpRequest
/de/docs/DOM/document	/de/docs/Web/API/Document
/de/docs/DOM/document.createElement	/de/docs/Web/API/Document/createElement
/de/docs/DOM/element	/de/docs/Web/API/Element
/de/docs/DOM/navigator.id	/de/docs/Web/API/Navigator/id
/de/docs/DOM/window	/de/docs/Web/API/Window
/de/docs/DOM/window.dump	/de/docs/Web/API/Window/dump
/de/docs/DOM/window.openDialog	/de/docs/Web/API/Window/openDialog
/de/docs/DOM/window.setTimeout	/de/docs/Web/API/Window/setTimeout
/de/docs/Developer_Guide	/de/docs/Mozilla/Developer_guide
/de/docs/Developer_Guide/firefox_erfolgreich_erstellt	/de/docs/Mozilla/Developer_guide/firefox_erfolgreich_erstellt
/de/docs/Eine_erste_Erweiterung_erstellen	/de/docs/Erweiterung_erstellen
/de/docs/Einfacher_Thunderbird_build	/de/docs/Mozilla/Developer_guide/Build_Anweisungen/Einfacher_Thunderbird_build
/de/docs/Einführung_in_den_Gebrauch_von_XPath_in_JavaScript	/de/docs/Web/JavaScript/Einf%C3%BChrung_in_den_Gebrauch_von_XPath_in_JavaScript
/de/docs/Einleitung	/de/docs/Mozilla/Developer_guide/Einleitung
/de/docs/Entwicklerhandbuch	/de/docs/Developer_Guide
/de/docs/Entwicklerhandbuch/Build_Anweisungen	/de/docs/Mozilla/Developer_guide/Build_Anweisungen
/de/docs/Entwicklerhandbuch/Build_Anweisungen/TOC	/de/docs/Mozilla/Developer_guide/Build_Anweisungen/TOC
/de/docs/Entwicklerhandbuch/Build_Anweisungen/Windows_Build_Voraussetzungen	/de/docs/Mozilla/Developer_guide/Build_Anweisungen/Windows_Build_Voraussetzungen
/de/docs/Entwicklerhandbuch/Quelltexte	/de/docs/Mozilla/Developer_guide/Quelltexte
/de/docs/Entwicklerhandbuch/Quelltexte/Mozilla_Quelltexte_herunterladen	/de/docs/Mozilla/Developer_guide/Quelltexte/Mozilla_Quelltexte_herunterladen
/de/docs/Entwicklerhandbuch/Quelltexte/Verzeichnis_struktur	/de/docs/Mozilla/Developer_guide/Quelltexte/Verzeichnis_struktur
/de/docs/Error_Console	/docs/de/Fehlerkonsole
/de/docs/Firefox_1.5_Beta	/docs/de/Firefox_1.5_f%C3%BCr_Entwickler
/de/docs/Gecko_Plugin_API_Reference	/docs/de/Gecko_Plugin_API_Referenz
/de/docs/Gecko_Plugin_API_Reference/Scripting_plugins	/docs/de/Gecko_Plugin_API_Referenz/Scripting_plugins
/de/docs/HTML	/de/docs/Web/HTML
/de/docs/HTML/Block-level_elemente	/de/docs/Web/HTML/Block-level_elemente
/de/docs/HTML/Element	/de/docs/Web/HTML/Element
/de/docs/HTML/Element/Input	/de/docs/Web/HTML/Element/Input
/de/docs/HTML/Element/b	/de/docs/Web/HTML/Element/b
/de/docs/HTML/Element/br	/de/docs/Web/HTML/Element/br
/de/docs/HTML/Element/canvas	/de/docs/Web/HTML/Element/canvas
/de/docs/HTML/Element/datalist	/de/docs/Web/HTML/Element/datalist
/de/docs/HTML/Element/h1	/de/docs/Web/HTML/Element/h1
/de/docs/HTML/Element/h1-h6	/de/docs/Web/HTML/Element/h1-h6
/de/docs/HTML/Element/h2	/de/docs/Web/HTML/Element/h2
/de/docs/HTML/Element/h3	/de/docs/Web/HTML/Element/h3
/de/docs/HTML/Element/h4	/de/docs/Web/HTML/Element/h4
/de/docs/HTML/Element/h5	/de/docs/Web/HTML/Element/h5
/de/docs/HTML/Element/h6	/de/docs/Web/HTML/Element/h6
/de/docs/HTML/Element/head	/de/docs/Web/HTML/Element/head
/de/docs/HTML/Element/hr	/de/docs/Web/HTML/Element/hr
/de/docs/HTML/Element/html	/de/docs/Web/HTML/Element/html
/de/docs/HTML/Element/iframe	/de/docs/Web/HTML/Element/iframe
/de/docs/HTML/Element/li	/de/docs/Web/HTML/Element/li
/de/docs/HTML/Element/noscript	/de/docs/Web/HTML/Element/noscript
/de/docs/HTML/Element/ol	/de/docs/Web/HTML/Element/ol
/de/docs/HTML/Element/p	/de/docs/Web/HTML/Element/p
/de/docs/HTML/Element/pre	/de/docs/Web/HTML/Element/pre
/de/docs/HTML/Element/strong	/de/docs/Web/HTML/Element/strong
/de/docs/HTML/Element/time	/de/docs/Web/HTML/Element/time
/de/docs/HTML/Element/ul	/de/docs/Web/HTML/Element/ul
/de/docs/HTML/Element/var	/de/docs/Web/HTML/Element/var
/de/docs/HTML/HTML5	/de/docs/Web/HTML/HTML5
/de/docs/HTML/HTML5/HTML5_element_list	/de/docs/Web/HTML/HTML5/HTML5_element_list
/de/docs/HTML/HTML5/liste_der_HTML5_elemente	/de/docs/HTML/HTML5/HTML5_element_list
/de/docs/HTML/HTML_Lernen_für_Anfänger	/de/docs/Web/HTML/HTML_Lernen_f%C3%BCr_Anf%C3%A4nger
/de/docs/HTML/Inline_elemente	/de/docs/Web/HTML/Inline_elemente
/de/docs/HTML/Using_HTML5_audio_and_video	/de/docs/Web/HTML/Using_HTML5_audio_and_video
/de/docs/HTML/Using_the_application_cache	/de/docs/Web/HTML/Using_the_application_cache
/de/docs/HTML:Beispiele	/docs/de/HTML/Beispiele
/de/docs/HTML:Element	/docs/de/HTML/Element
/de/docs/HTML:Element:b	/docs/de/HTML/Element/b
/de/docs/HTML:Element:h1	/docs/de/HTML/Element/h1
/de/docs/HTML:Element:h2	/docs/de/HTML/Element/h2
/de/docs/HTML:Element:h3	/docs/de/HTML/Element/h3
/de/docs/HTML:Element:h4	/docs/de/HTML/Element/h4
/de/docs/HTML:Element:h5	/docs/de/HTML/Element/h5
/de/docs/HTML:Element:h6	/docs/de/HTML/Element/h6
/de/docs/HTML:Element:head	/docs/de/HTML/Element/head
/de/docs/HTML:Element:hr	/docs/de/HTML/Element/hr
/de/docs/HTML:Element:html	/docs/de/HTML/Element/html
/de/docs/HTML:Element:iframe	/docs/de/HTML/Element/iframe
/de/docs/HTML:Element:li	/docs/de/HTML/Element/li
/de/docs/HTML:Element:ol	/docs/de/HTML/Element/ol
/de/docs/HTML:Element:p	/docs/de/HTML/Element/p
/de/docs/HTML:Element:strong	/docs/de/HTML/Element/strong
/de/docs/HTML:Element:ul	/docs/de/HTML/Element/ul
/de/docs/HTML:Element:var	/docs/de/HTML/Element/var
/de/docs/HTTP_Request_Header_setzen	/de/docs/XPCOM/HTTP_Request_Header_setzen
/de/docs/Hauptseite	/docs/de
/de/docs/JavaScript	/de/docs/Web/JavaScript
/de/docs/JavaScript/Eine_Wiedereinfuehrung_in_JavaScript	/de/docs/Web/JavaScript/Eine_Wiedereinfuehrung_in_JavaScript
/de/docs/JavaScript/Guide	/de/docs/Web/JavaScript/Guide
/de/docs/JavaScript/Guide/Ausdruecke_und_Operatoren	/de/docs/Web/JavaScript/Guide/Ausdruecke_und_Operatoren
/de/docs/JavaScript/Guide/Closures	/de/docs/Web/JavaScript/Guide/Closures
/de/docs/JavaScript/Guide/Feinheiten_des_Objektmodells	/de/docs/Web/JavaScript/Guide/Feinheiten_des_Objektmodells
/de/docs/JavaScript/Guide/Funktionen	/de/docs/Web/JavaScript/Guide/Funktionen
/de/docs/JavaScript/Guide/Iteratoren_und_Generatoren	/de/docs/Web/JavaScript/Guide/Iteratoren_und_Generatoren
/de/docs/JavaScript/Guide/Mit_Objekten_arbeiten	/de/docs/Web/JavaScript/Guide/Mit_Objekten_arbeiten
/de/docs/JavaScript/Guide/Regular_Expressions	/de/docs/Web/JavaScript/Guide/Regular_Expressions
/de/docs/JavaScript/Guide/Statements	/de/docs/Web/JavaScript/Guide/Statements
/de/docs/JavaScript/Guide/Ueber_JavaScript	/de/docs/Web/JavaScript/Guide/Ueber_JavaScript
/de/docs/JavaScript/Guide/Ueber_diese_Einfuehrung	/de/docs/Web/JavaScript/Guide/Ueber_diese_Einfuehrung
/de/docs/JavaScript/Guide/Vererbung_ueberdacht	/de/docs/Web/JavaScript/Guide/Vererbung_ueberdacht
/de/docs/JavaScript/Guide/Vordefinierte_Kernobjekte	/de/docs/Web/JavaScript/Guide/Vordefinierte_Kernobjekte
/de/docs/JavaScript/Guide/Werte_Variablen_und_Literale	/de/docs/Web/JavaScript/Guide/Werte_Variablen_und_Literale
/de/docs/JavaScript/Guide/Über_Javascript	/de/docs/Web/JavaScript/Guide/%C3%9Cber_Javascript
/de/docs/JavaScript/Guide/Über_diese_Einführung	/de/docs/Web/JavaScript/Guide/%C3%9Cber_diese_Einf%C3%BChrung
/de/docs/JavaScript/JQuery	/de/docs/Web/JavaScript/JQuery
/de/docs/JavaScript/Javascript_lernen_für_Anfänger	/de/docs/Web/JavaScript/Javascript_lernen_f%C3%BCr_Anf%C3%A4nger
/de/docs/JavaScript/Language_Resources	/de/docs/Web/JavaScript/Language_Resources
/de/docs/JavaScript/Neu_in_JavaScript	/de/docs/Web/JavaScript/Neu_in_JavaScript
/de/docs/JavaScript/Neu_in_JavaScript/1.5	/de/docs/Web/JavaScript/Neu_in_JavaScript/1.5
/de/docs/JavaScript/Neu_in_JavaScript/1.6	/de/docs/Web/JavaScript/Neu_in_JavaScript/1.6
/de/docs/JavaScript/Neu_in_JavaScript/1.7	/de/docs/Web/JavaScript/Neu_in_JavaScript/1.7
/de/docs/JavaScript/Neu_in_JavaScript/1.8	/de/docs/Web/JavaScript/Neu_in_JavaScript/1.8
/de/docs/JavaScript/Neu_in_JavaScript/1.8.1	/de/docs/Web/JavaScript/Neu_in_JavaScript/1.8.1
/de/docs/JavaScript/Neu_in_JavaScript/1.8.5	/de/docs/Web/JavaScript/Neu_in_JavaScript/1.8.5
/de/docs/JavaScript/Reference	/de/docs/Web/JavaScript/Reference
/de/docs/JavaScript/Reference/Global_Objects	/de/docs/Web/JavaScript/Reference/Global_Objects
/de/docs/JavaScript/Reference/Global_Objects/Array	/de/docs/Web/JavaScript/Reference/Global_Objects/Array
/de/docs/JavaScript/Reference/Global_Objects/Array/isArray	/de/docs/Web/JavaScript/Reference/Global_Objects/Array/isArray
/de/docs/JavaScript/Reference/Global_Objects/Array/pop	/de/docs/Web/JavaScript/Reference/Global_Objects/Array/pop
/de/docs/JavaScript/Reference/Global_Objects/Array/push	/de/docs/Web/JavaScript/Reference/Global_Objects/Array/push
/de/docs/JavaScript/Reference/Global_Objects/Array/reverse	/de/docs/Web/JavaScript/Reference/Global_Objects/Array/reverse
/de/docs/JavaScript/Reference/Global_Objects/Array/shift	/de/docs/Web/JavaScript/Reference/Global_Objects/Array/shift
/de/docs/JavaScript/Reference/Global_Objects/Date	/de/docs/Web/JavaScript/Reference/Global_Objects/Date
/de/docs/JavaScript/Reference/Global_Objects/Date/now	/de/docs/Web/JavaScript/Reference/Global_Objects/Date/now
/de/docs/JavaScript/Reference/Global_Objects/NaN	/de/docs/Web/JavaScript/Reference/Global_Objects/NaN
/de/docs/JavaScript/Reference/Global_Objects/Number	/de/docs/Web/JavaScript/Reference/Global_Objects/Number
/de/docs/JavaScript/Reference/Global_Objects/Number/EPSILON	/de/docs/Web/JavaScript/Reference/Global_Objects/Number/EPSILON
/de/docs/JavaScript/Reference/Global_Objects/Object	/de/docs/Web/JavaScript/Reference/Global_Objects/Object
/de/docs/JavaScript/Reference/Global_Objects/Object/constructor	/de/docs/Web/JavaScript/Reference/Global_Objects/Object/constructor
/de/docs/JavaScript/Reference/Global_Objects/Object/is	/de/docs/Web/JavaScript/Reference/Global_Objects/Object/is
/de/docs/JavaScript/Reference/Global_Objects/Object/propertyIsEnumerable	/de/docs/Web/JavaScript/Reference/Global_Objects/Object/propertyIsEnumerable
/de/docs/JavaScript/Reference/Global_Objects/RegExp	/de/docs/Web/JavaScript/Reference/Global_Objects/RegExp
/de/docs/JavaScript/Reference/Global_Objects/String	/de/docs/Web/JavaScript/Reference/Global_Objects/String
/de/docs/JavaScript/Reference/Global_Objects/String/replace	/de/docs/Web/JavaScript/Reference/Global_Objects/String/replace
/de/docs/JavaScript/Speicherverwaltung	/de/docs/Web/JavaScript/Speicherverwaltung
/de/docs/JavaScript/java_guide	/de/docs/Web/JavaScript/java_guide
/de/docs/JavaScript/javascript_guide	/de/docs/Web/JavaScript/javascript_guide
/de/docs/JavaScript/javascript_guide/Anweisungen	/de/docs/JavaScript/Guide/Statements
/de/docs/JavaScript/javascript_guide/Ausdrücke_und_Operatoren	/de/docs/Web/JavaScript/javascript_guide/Ausdr%C3%BCcke_und_Operatoren
/de/docs/JavaScript/javascript_guide/Funktionen	/de/docs/Web/JavaScript/Guide/Funktionen
/de/docs/JavaScript/javascript_guide/Javascript_Übersicht	/de/docs/Web/JavaScript/javascript_guide/Javascript_%C3%9Cbersicht
/de/docs/JavaScript/javascript_guide/Mit_Objekten_arbeiten	/de/docs/Web/JavaScript/Guide/Mit_Objekten_arbeiten
/de/docs/JavaScript/javascript_guide/Reguläre_Ausdrücke	/de/docs/JavaScript/Guide/Regular_Expressions
/de/docs/JavaScript/javascript_guide/Werte,_Variable_und_Literale	/de/docs/Web/JavaScript/javascript_guide/Werte,_Variable_und_Literale
/de/docs/JavaScript/javascript_guide/Werte,_Variablen_und_Literale	/de/docs/Web/JavaScript/javascript_guide/Werte,_Variablen_und_Literale
/de/docs/JavaScript/javascript_guide/ueber_javascript	/de/docs/Web/JavaScript/javascript_guide/ueber_javascript
/de/docs/JavaScript/javascript_guide/ueber_javascript/Über_Javascript	/de/docs/Web/JavaScript/javascript_guide/ueber_javascript/%C3%9Cber_Javascript
/de/docs/JavaScript/javascript_guide/Über_Javascript	/de/docs/Web/JavaScript/javascript_guide/%C3%9Cber_Javascript
/de/docs/JavaScript/javascript_guide/Über_diese_Einführung	/de/docs/Web/JavaScript/javascript_guide/%C3%9Cber_diese_Einf%C3%BChrung
/de/docs/JavaScript/ueber_JavaScript	/de/docs/Web/JavaScript/ueber_JavaScript
/de/docs/JavaScript/ueber_JavaScript/Über_Javascript	/de/docs/Web/JavaScript/ueber_JavaScript/%C3%9Cber_Javascript
/de/docs/JavaScript/Über_Javascript	/de/docs/Web/JavaScript/%C3%9Cber_Javascript
/de/docs/Learn/CSS/Introduction_to_CSS	/en-US/docs/Learn/CSS/First_steps
/de/docs/Learn/CSS/Introduction_to_CSS/Attribute_selectors	/en-US/docs/Learn/CSS/Building_blocks/Selectors/Attribute_selectors
/de/docs/Learn/CSS/Introduction_to_CSS/Cascade_and_inheritance	/en-US/docs/Learn/CSS/Building_blocks/Cascade_and_inheritance
/de/docs/Learn/CSS/Introduction_to_CSS/Combinators_and_multiple_selectors	/en-US/docs/Learn/CSS/Building_blocks/Selectors/Combinators
/de/docs/Learn/CSS/Introduction_to_CSS/How_CSS_works	/en-US/docs/Learn/CSS/First_steps/How_CSS_works
/de/docs/Learn/CSS/Introduction_to_CSS/Pseudo-classes_and_pseudo-elements	/en-US/docs/Learn/CSS/Building_blocks/Selectors/Pseudo-classes_and_pseudo-elements
/de/docs/Learn/CSS/Introduction_to_CSS/Simple_selectors	/en-US/docs/Learn/CSS/Building_blocks/Selectors/Type_Class_and_ID_Selectors
/de/docs/Learn/CSS/Introduction_to_CSS/Syntax	/en-US/docs/Learn/CSS/First_steps/How_CSS_is_structured
/de/docs/Learn/CSS/Introduction_to_CSS/Values_and_units	/en-US/docs/Learn/CSS/Building_blocks/Values_and_units
/de/docs/Learn/CSS/Styling_boxes	/en-US/docs/Learn/CSS/Building_blocks
/de/docs/MDC_style_guide/MDC_style_guide	/docs/Project:En/MDC_style_guide
/de/docs/MDN/Contribute/Content	/de/docs/MDN/Contribute/Guidelines
/de/docs/MDN/Contribute/Content/Style_guide	/de/docs/MDN/Contribute/Guidelines/Style_guide
/de/docs/MDN/Doc_status/Firefox_OS	/de/docs/MDN/Doc_status/B2G_OS
/de/docs/MindTouch_Deki_bug_priorities	/docs/User:Sheppy/MindTouch_Deki_bug_priorities
/de/docs/Mozilla/B2G_OS	/de/docs/Archive/B2G_OS
/de/docs/Mozilla/B2G_OS/Anwendungsentwicklung	/de/docs/Archive/B2G_OS/Anwendungsentwicklung
/de/docs/Mozilla/B2G_OS/Apps	/de/docs/Archive/B2G_OS/Apps
/de/docs/Mozilla/B2G_OS/Apps/eine_app_für_firefox_os_schreiben	/de/docs/Archive/B2G_OS/Apps/eine_app_f%C3%BCr_firefox_os_schreiben
/de/docs/Mozilla/B2G_OS/Arbeiten_mit_dem_B2G_Desktop_Client	/de/docs/Archive/B2G_OS/Arbeiten_mit_dem_B2G_Desktop_Client
/de/docs/Mozilla/B2G_OS/Benutzung_des_App_Managers	/de/docs/Archive/B2G_OS/Benutzung_des_App_Managers
/de/docs/Mozilla/B2G_OS/Building	/de/docs/Archive/B2G_OS/Building
/de/docs/Mozilla/B2G_OS/Building_and_installing_Firefox_OS	/de/docs/Archive/B2G_OS/Building_and_installing_Firefox_OS
/de/docs/Mozilla/B2G_OS/Building_and_installing_Firefox_OS/Firefox_OS_build_overview	/de/docs/Archive/B2G_OS/Building_and_installing_Firefox_OS/Firefox_OS_build_overview
/de/docs/Mozilla/B2G_OS/Debugging	/de/docs/Archive/B2G_OS/Debugging
/de/docs/Mozilla/B2G_OS/Debugging/Developer_settings	/de/docs/Archive/B2G_OS/Debugging/Developer_settings
/de/docs/Mozilla/B2G_OS/Debugging/Installing_ADB	/de/docs/Archive/B2G_OS/Debugging/Installing_ADB
/de/docs/Mozilla/B2G_OS/Debugging/Verbinden_eines_Firefox_OS_Geräts_mit_dem_Rechner	/de/docs/Archive/B2G_OS/Debugging/Verbinden_eines_Firefox_OS_Ger%C3%A4ts_mit_dem_Rechner
/de/docs/Mozilla/B2G_OS/Developer_phone_guide	/de/docs/Archive/B2G_OS/Developer_phone_guide
/de/docs/Mozilla/B2G_OS/Developer_phone_guide/Alcatel_One_Touch_Fire	/de/docs/Archive/B2G_OS/Developer_phone_guide/Alcatel_One_Touch_Fire
/de/docs/Mozilla/B2G_OS/Developer_phone_guide/Flame	/de/docs/Archive/B2G_OS/Developer_phone_guide/Flame
/de/docs/Mozilla/B2G_OS/Developer_phone_guide/Geeksphone	/de/docs/Archive/B2G_OS/Developer_phone_guide/Geeksphone
/de/docs/Mozilla/B2G_OS/Developer_phone_guide/Phone_specs	/de/docs/Archive/B2G_OS/Developer_phone_guide/Phone_specs
/de/docs/Mozilla/B2G_OS/Developer_phone_guide/ZTE_OPEN_C	/de/docs/Archive/B2G_OS/Developer_phone_guide/ZTE_OPEN_C
/de/docs/Mozilla/B2G_OS/Einführung	/de/docs/Archive/B2G_OS/Einf%C3%BChrung
/de/docs/Mozilla/B2G_OS/Firefox_OS_FAQ	/de/docs/Archive/B2G_OS/Firefox_OS_FAQ
/de/docs/Mozilla/B2G_OS/Firefox_OS_build_prerequisites	/de/docs/Archive/B2G_OS/Firefox_OS_build_prerequisites
/de/docs/Mozilla/B2G_OS/Gaia	/de/docs/Archive/B2G_OS/Gaia
/de/docs/Mozilla/B2G_OS/Gaia/Gaia_apps	/de/docs/Archive/B2G_OS/Gaia/Gaia_apps
/de/docs/Mozilla/B2G_OS/Gaia/Hacking	/de/docs/Archive/B2G_OS/Gaia/Hacking
/de/docs/Mozilla/B2G_OS/Gaia/Introduction_to_Gaia	/de/docs/Archive/B2G_OS/Gaia/Introduction_to_Gaia
/de/docs/Mozilla/B2G_OS/Gaia_Entwickeln	/de/docs/Archive/B2G_OS/Gaia_Entwickeln
/de/docs/Mozilla/B2G_OS/Gaia_Entwickeln/Build_System_Primer	/de/docs/Archive/B2G_OS/Gaia_Entwickeln/Build_System_Primer
/de/docs/Mozilla/B2G_OS/Gaia_Entwickeln/Customizing_build-time_apps	/de/docs/Archive/B2G_OS/Gaia_Entwickeln/Customizing_build-time_apps
/de/docs/Mozilla/B2G_OS/Gaia_Entwickeln/Durchfuehrung_der_Gaia_codebase	/de/docs/Archive/B2G_OS/Gaia_Entwickeln/Durchfuehrung_der_Gaia_codebase
/de/docs/Mozilla/B2G_OS/Gaia_Entwickeln/Making_Gaia_code_changes	/de/docs/Archive/B2G_OS/Gaia_Entwickeln/Making_Gaia_code_changes
/de/docs/Mozilla/B2G_OS/Hacking_Firefox_OS	/de/docs/Archive/B2G_OS/Hacking_Firefox_OS
/de/docs/Mozilla/B2G_OS/Hacking_Firefox_OS/Filing_bugs_against_Firefox_OS	/de/docs/Archive/B2G_OS/Hacking_Firefox_OS/Filing_bugs_against_Firefox_OS
/de/docs/Mozilla/B2G_OS/Installing_on_a_mobile_device	/de/docs/Archive/B2G_OS/Installing_on_a_mobile_device
/de/docs/Mozilla/B2G_OS/Platform	/de/docs/Archive/B2G_OS/Platform
/de/docs/Mozilla/B2G_OS/Platform/App_Architektur	/de/docs/Archive/B2G_OS/Platform/App_Architektur
/de/docs/Mozilla/B2G_OS/Platform/Architektur	/de/docs/Archive/B2G_OS/Platform/Architektur
/de/docs/Mozilla/B2G_OS/Releases	/de/docs/Archive/B2G_OS/Releases
/de/docs/Mozilla/B2G_OS/Releases/1.4	/de/docs/Archive/B2G_OS/Releases/1.4
/de/docs/Mozilla/B2G_OS/Releases/2.0	/de/docs/Archive/B2G_OS/Releases/2.0
/de/docs/Mozilla/B2G_OS/Troubleshooting	/de/docs/Archive/B2G_OS/Troubleshooting
/de/docs/Mozilla/Boot_to_Gecko/Anwendungsentwicklung	/de/docs/Mozilla/B2G_OS/Anwendungsentwicklung
/de/docs/Mozilla/Firefox_OS	/de/docs/Mozilla/B2G_OS
/de/docs/Mozilla/Firefox_OS/Apps	/de/docs/Mozilla/B2G_OS/Apps
/de/docs/Mozilla/Firefox_OS/Apps/eine_app_für_firefox_os_schreiben	/de/docs/Mozilla/B2G_OS/Apps/eine_app_f%C3%BCr_firefox_os_schreiben
/de/docs/Mozilla/Firefox_OS/Arbeiten_mit_dem_B2G_Desktop_Client	/de/docs/Mozilla/B2G_OS/Arbeiten_mit_dem_B2G_Desktop_Client
/de/docs/Mozilla/Firefox_OS/Benutzung_des_App_Managers	/de/docs/Mozilla/B2G_OS/Benutzung_des_App_Managers
/de/docs/Mozilla/Firefox_OS/Building	/de/docs/Mozilla/B2G_OS/Building
/de/docs/Mozilla/Firefox_OS/Building_and_installing_Firefox_OS	/de/docs/Mozilla/B2G_OS/Building_and_installing_Firefox_OS
/de/docs/Mozilla/Firefox_OS/Building_and_installing_Firefox_OS/Firefox_OS_build_overview	/de/docs/Mozilla/B2G_OS/Building_and_installing_Firefox_OS/Firefox_OS_build_overview
/de/docs/Mozilla/Firefox_OS/Debugging	/de/docs/Mozilla/B2G_OS/Debugging
/de/docs/Mozilla/Firefox_OS/Debugging/Developer_settings	/de/docs/Mozilla/B2G_OS/Debugging/Developer_settings
/de/docs/Mozilla/Firefox_OS/Debugging/Installing_ADB	/de/docs/Mozilla/B2G_OS/Debugging/Installing_ADB
/de/docs/Mozilla/Firefox_OS/Debugging/Verbinden_eines_Firefox_OS_Geräts_mit_dem_Rechner	/de/docs/Mozilla/B2G_OS/Debugging/Verbinden_eines_Firefox_OS_Ger%C3%A4ts_mit_dem_Rechner
/de/docs/Mozilla/Firefox_OS/Developer_phone_guide	/de/docs/Mozilla/B2G_OS/Developer_phone_guide
/de/docs/Mozilla/Firefox_OS/Developer_phone_guide/Alcatel_One_Touch_Fire	/de/docs/Mozilla/B2G_OS/Developer_phone_guide/Alcatel_One_Touch_Fire
/de/docs/Mozilla/Firefox_OS/Developer_phone_guide/Flame	/de/docs/Mozilla/B2G_OS/Developer_phone_guide/Flame
/de/docs/Mozilla/Firefox_OS/Developer_phone_guide/Geeksphone	/de/docs/Mozilla/B2G_OS/Developer_phone_guide/Geeksphone
/de/docs/Mozilla/Firefox_OS/Developer_phone_guide/Phone_specs	/de/docs/Mozilla/B2G_OS/Developer_phone_guide/Phone_specs
/de/docs/Mozilla/Firefox_OS/Developer_phone_guide/ZTE_OPEN_C	/de/docs/Mozilla/B2G_OS/Developer_phone_guide/ZTE_OPEN_C
/de/docs/Mozilla/Firefox_OS/Einführung	/de/docs/Mozilla/B2G_OS/Einf%C3%BChrung
/de/docs/Mozilla/Firefox_OS/Firefox_OS_FAQ	/de/docs/Mozilla/B2G_OS/Firefox_OS_FAQ
/de/docs/Mozilla/Firefox_OS/Firefox_OS_build_prerequisites	/de/docs/Mozilla/B2G_OS/Firefox_OS_build_prerequisites
/de/docs/Mozilla/Firefox_OS/Gaia	/de/docs/Mozilla/B2G_OS/Gaia
/de/docs/Mozilla/Firefox_OS/Gaia/Gaia_apps	/de/docs/Mozilla/B2G_OS/Gaia/Gaia_apps
/de/docs/Mozilla/Firefox_OS/Gaia/Hacking	/de/docs/Mozilla/B2G_OS/Gaia/Hacking
/de/docs/Mozilla/Firefox_OS/Gaia/Introduction_to_Gaia	/de/docs/Mozilla/B2G_OS/Gaia/Introduction_to_Gaia
/de/docs/Mozilla/Firefox_OS/Gaia_Entwickeln	/de/docs/Mozilla/B2G_OS/Gaia_Entwickeln
/de/docs/Mozilla/Firefox_OS/Gaia_Entwickeln/Build_System_Primer	/de/docs/Mozilla/B2G_OS/Gaia_Entwickeln/Build_System_Primer
/de/docs/Mozilla/Firefox_OS/Gaia_Entwickeln/Customizing_build-time_apps	/de/docs/Mozilla/B2G_OS/Gaia_Entwickeln/Customizing_build-time_apps
/de/docs/Mozilla/Firefox_OS/Gaia_Entwickeln/Durchfuehrung_der_Gaia_codebase	/de/docs/Mozilla/B2G_OS/Gaia_Entwickeln/Durchfuehrung_der_Gaia_codebase
/de/docs/Mozilla/Firefox_OS/Gaia_Entwickeln/Making_Gaia_code_changes	/de/docs/Mozilla/B2G_OS/Gaia_Entwickeln/Making_Gaia_code_changes
/de/docs/Mozilla/Firefox_OS/Hacking_Firefox_OS	/de/docs/Mozilla/B2G_OS/Hacking_Firefox_OS
/de/docs/Mozilla/Firefox_OS/Hacking_Firefox_OS/Filing_bugs_against_Firefox_OS	/de/docs/Mozilla/B2G_OS/Hacking_Firefox_OS/Filing_bugs_against_Firefox_OS
/de/docs/Mozilla/Firefox_OS/Installing_on_a_mobile_device	/de/docs/Mozilla/B2G_OS/Installing_on_a_mobile_device
/de/docs/Mozilla/Firefox_OS/Platform	/de/docs/Mozilla/B2G_OS/Platform
/de/docs/Mozilla/Firefox_OS/Platform/App_Architektur	/de/docs/Mozilla/B2G_OS/Platform/App_Architektur
/de/docs/Mozilla/Firefox_OS/Platform/Architektur	/de/docs/Mozilla/B2G_OS/Platform/Architektur
/de/docs/Mozilla/Firefox_OS/Releases	/de/docs/Mozilla/B2G_OS/Releases
/de/docs/Mozilla/Firefox_OS/Releases/1.4	/de/docs/Mozilla/B2G_OS/Releases/1.4
/de/docs/Mozilla/Firefox_OS/Releases/2.0	/de/docs/Mozilla/B2G_OS/Releases/2.0
/de/docs/Mozilla/Firefox_OS/Troubleshooting	/de/docs/Mozilla/B2G_OS/Troubleshooting
/de/docs/Mozilla/Marketplace/APIs	/de/docs/Archive/Mozilla/Marketplace/APIs
/de/docs/Mozilla/Marketplace/FAQ	/de/docs/Archive/Mozilla/Marketplace/FAQ
/de/docs/Mozilla/Marketplace/Index	/de/docs/Archive/Mozilla/Marketplace/Index
/de/docs/Mozilla/Marketplace/Marktplatz_APIs	/de/docs/Archive/Mozilla/Marketplace/Marktplatz_APIs
/de/docs/Mozilla/Marketplace/Options	/de/docs/Archive/Mozilla/Marketplace/Options
/de/docs/Mozilla/Marketplace/Options/Open_web_apps_for_android	/de/docs/Archive/Mozilla/Marketplace/Options/Open_web_apps_for_android
/de/docs/Mozilla/Marketplace/Publishing	/de/docs/Archive/Mozilla/Marketplace/Publishing
/de/docs/Mozilla/Marketplace/Publishing/Packaged_apps	/de/docs/Archive/Mozilla/Marketplace/Publishing/Packaged_apps
/de/docs/Mozilla/Marketplace/Publishing/Publish_options	/de/docs/Archive/Mozilla/Marketplace/Publishing/Publish_options
/de/docs/Mozilla/Marketplace/Publishing/Submit	/de/docs/Archive/Mozilla/Marketplace/Publishing/Submit
/de/docs/Mozilla/Marketplace/Publishing/Updating_apps	/de/docs/Archive/Mozilla/Marketplace/Publishing/Updating_apps
/de/docs/Mozilla/Marketplace/Submission	/de/docs/Archive/Mozilla/Marketplace/Submission
/de/docs/Mozilla/Marketplace/Submission/Marketplace_review_criteria	/de/docs/Archive/Mozilla/Marketplace/Submission/Marketplace_review_criteria
/de/docs/Mozilla/Marketplace/Veröffentlichen	/de/docs/Archive/Mozilla/Marketplace/Ver%C3%B6ffentlichen
/de/docs/Mozilla/Projects/Thunderbird	/docs/en/Thunderbird
/de/docs/Mozilla/Tech/XUL	/de/docs/Archive/Mozilla/XUL
/de/docs/Mozilla/Tech/XUL/Arrowscrollbox	/de/docs/Archive/Mozilla/XUL/Arrowscrollbox
/de/docs/Mozilla/Tech/XUL/Assign	/de/docs/Archive/Mozilla/XUL/Assign
/de/docs/Mozilla/Tech/XUL/Attribute	/de/docs/Archive/Mozilla/XUL/Attribute
/de/docs/Mozilla/Tech/XUL/Attribute/Activetitlebarcolor	/de/docs/Archive/Mozilla/XUL/Attribute/Activetitlebarcolor
/de/docs/Mozilla/Tech/XUL/Attribute/Color	/de/docs/Archive/Mozilla/XUL/Attribute/Color
/de/docs/Mozilla/Tech/XUL/Attribute/Cols	/de/docs/Archive/Mozilla/XUL/Attribute/Cols
/de/docs/Mozilla/Tech/XUL/Attribute/Decimalplaces	/de/docs/Archive/Mozilla/XUL/Attribute/Decimalplaces
/de/docs/Mozilla/Tech/XUL/Attribute/Disabled	/de/docs/Archive/Mozilla/XUL/Attribute/Disabled
/de/docs/Mozilla/Tech/XUL/Attribute/Empty	/de/docs/Archive/Mozilla/XUL/Attribute/Empty
/de/docs/Mozilla/Tech/XUL/Attribute/Emptytext	/de/docs/Archive/Mozilla/XUL/Attribute/Emptytext
/de/docs/Mozilla/Tech/XUL/Attribute/Expr	/de/docs/Archive/Mozilla/XUL/Attribute/Expr
/de/docs/Mozilla/Tech/XUL/Attribute/Hidespinbuttons	/de/docs/Archive/Mozilla/XUL/Attribute/Hidespinbuttons
/de/docs/Mozilla/Tech/XUL/Attribute/Onchange	/de/docs/Archive/Mozilla/XUL/Attribute/Onchange
/de/docs/Mozilla/Tech/XUL/Attribute/Var	/de/docs/Archive/Mozilla/XUL/Attribute/Var
/de/docs/Mozilla/Tech/XUL/Attribute/accesskey	/de/docs/Archive/Mozilla/XUL/Attribute/accesskey
/de/docs/Mozilla/Tech/XUL/Attribute/align	/de/docs/Archive/Mozilla/XUL/Attribute/align
/de/docs/Mozilla/Tech/XUL/Attribute/allowevents	/de/docs/Archive/Mozilla/XUL/Attribute/allowevents
/de/docs/Mozilla/Tech/XUL/Attribute/allownegativeassertions	/de/docs/Archive/Mozilla/XUL/Attribute/allownegativeassertions
/de/docs/Mozilla/Tech/XUL/Attribute/label	/de/docs/Archive/Mozilla/XUL/Attribute/label
/de/docs/Mozilla/Tech/XUL/Attribute/prefpane.src	/de/docs/Archive/Mozilla/XUL/Attribute/prefpane.src
/de/docs/Mozilla/Tech/XUL/Attribute/src	/de/docs/Archive/Mozilla/XUL/Attribute/src
/de/docs/Mozilla/Tech/XUL/Attribute/treecell.src	/de/docs/Archive/Mozilla/XUL/Attribute/treecell.src
/de/docs/Mozilla/Tech/XUL/Attribute/treecol.src	/de/docs/Archive/Mozilla/XUL/Attribute/treecol.src
/de/docs/Mozilla/Tech/XUL/Bbox	/de/docs/Archive/Mozilla/XUL/Bbox
/de/docs/Mozilla/Tech/XUL/Binding	/de/docs/Archive/Mozilla/XUL/Binding
/de/docs/Mozilla/Tech/XUL/Box	/de/docs/Archive/Mozilla/XUL/Box
/de/docs/Mozilla/Tech/XUL/Colorpicker	/de/docs/Archive/Mozilla/XUL/Colorpicker
/de/docs/Mozilla/Tech/XUL/Eigenschaften	/de/docs/Archive/Mozilla/XUL/Eigenschaften
/de/docs/Mozilla/Tech/XUL/Events	/de/docs/Archive/Mozilla/XUL/Events
/de/docs/Mozilla/Tech/XUL/Method	/de/docs/Archive/Mozilla/XUL/Method
/de/docs/Mozilla/Tech/XUL/Method/getIcon	/de/docs/Archive/Mozilla/XUL/Method/getIcon
/de/docs/Mozilla/Tech/XUL/Method/getTabForBrowser	/de/docs/Archive/Mozilla/XUL/Method/getTabForBrowser
/de/docs/Mozilla/Tech/XUL/Property	/de/docs/Archive/Mozilla/XUL/Property
/de/docs/Mozilla/Tech/XUL/School_tutorial	/de/docs/Archive/Mozilla/XUL/School_tutorial
/de/docs/Mozilla/Tech/XUL/School_tutorial/Adding_menus_and_submenus	/de/docs/Archive/Mozilla/XUL/School_tutorial/Adding_menus_and_submenus
/de/docs/Mozilla/Tech/XUL/School_tutorial/Die_Grundlagen_einer_Erweiterung	/de/docs/Archive/Mozilla/XUL/School_tutorial/Die_Grundlagen_einer_Erweiterung
/de/docs/Mozilla/Tech/XUL/School_tutorial/Eine_Entwicklungsumgebung_einrichten_Environment	/de/docs/Archive/Mozilla/XUL/School_tutorial/Eine_Entwicklungsumgebung_einrichten_Environment
/de/docs/Mozilla/Tech/XUL/School_tutorial/Einleitung	/de/docs/Archive/Mozilla/XUL/School_tutorial/Einleitung
/de/docs/Mozilla/Tech/XUL/School_tutorial/Getting_Started_with_Firefox_Extensions	/de/docs/Archive/Mozilla/XUL/School_tutorial/Getting_Started_with_Firefox_Extensions
/de/docs/Mozilla/Tech/XUL/Style	/de/docs/Archive/Mozilla/XUL/Style
/de/docs/Mozilla/Tech/XUL/Style/treecol-image	/de/docs/Archive/Mozilla/XUL/Style/treecol-image
/de/docs/Mozilla/Tech/XUL/Textbox	/de/docs/Archive/Mozilla/XUL/Textbox
/de/docs/Mozilla/Tech/XUL/Window	/de/docs/Archive/Mozilla/XUL/Window
/de/docs/Mozilla/Tech/XUL/XUL_Referenz	/de/docs/Archive/Mozilla/XUL/XUL_Referenz
/de/docs/Mozilla/Tech/XUL/XUL_Tutorial	/de/docs/Archive/Mozilla/XUL/XUL_Tutorial
/de/docs/Mozilla/Tech/XUL/XUL_Tutorial/Die_Chrome-URL	/de/docs/Archive/Mozilla/XUL/XUL_Tutorial/Die_Chrome-URL
/de/docs/Mozilla/Tech/XUL/XUL_Tutorial/Die_Chrome_URL	/de/docs/Archive/Mozilla/XUL/XUL_Tutorial/Die_Chrome_URL
/de/docs/Mozilla/Tech/XUL/XUL_Tutorial/Ein_Fenster_erzeugen	/de/docs/Archive/Mozilla/XUL/XUL_Tutorial/Ein_Fenster_erzeugen
/de/docs/Mozilla/Tech/XUL/XUL_Tutorial/Einfuehrung	/de/docs/Archive/Mozilla/XUL/XUL_Tutorial/Einfuehrung
/de/docs/Mozilla/Tech/XUL/XUL_Tutorial/Installations-Skripte	/de/docs/Archive/Mozilla/XUL/XUL_Tutorial/Installations-Skripte
/de/docs/Mozilla/Tech/XUL/XUL_Tutorial/Lokalisierung	/de/docs/Archive/Mozilla/XUL/XUL_Tutorial/Lokalisierung
/de/docs/Mozilla/Tech/XUL/XUL_Tutorial/Positionierung_von_Elementen	/de/docs/Archive/Mozilla/XUL/XUL_Tutorial/Positionierung_von_Elementen
/de/docs/Mozilla/Tech/XUL/XUL_Tutorial/XUL_Struktur	/de/docs/Archive/Mozilla/XUL/XUL_Tutorial/XUL_Struktur
/de/docs/Mozilla/Tech/XUL/action	/de/docs/Archive/Mozilla/XUL/action
/de/docs/Mozilla/Tech/XUL/grippy	/de/docs/Archive/Mozilla/XUL/grippy
/de/docs/Mozilla/Tech/XUL/iframe	/de/docs/Archive/Mozilla/XUL/iframe
/de/docs/Mozilla/Tech/XUL/separator	/de/docs/Archive/Mozilla/XUL/separator
/de/docs/Mozilla/Tech/XUL/spacer	/de/docs/Archive/Mozilla/XUL/spacer
/de/docs/Mozilla/Tech/XUL/splitter	/de/docs/Archive/Mozilla/XUL/splitter
/de/docs/Mozilla/Tech/XUL/tab	/de/docs/Archive/Mozilla/XUL/tab
/de/docs/Mozilla/Tech/XUL/tabbox	/de/docs/Archive/Mozilla/XUL/tabbox
/de/docs/Mozilla/Tech/XUL/tabpanels	/de/docs/Archive/Mozilla/XUL/tabpanels
/de/docs/Mozilla/Tech/XUL/tabs	/de/docs/Archive/Mozilla/XUL/tabs
/de/docs/Mozilla/Tech/XUL/treecol	/de/docs/Archive/Mozilla/XUL/treecol
/de/docs/Mozilla/Tech/XUL/vbox	/de/docs/Archive/Mozilla/XUL/vbox
/de/docs/Mozilla_Quelltexte_herunterladen	/docs/de/Entwicklerhandbuch/Quelltexte/Mozilla_Quelltexte_herunterladen
/de/docs/Mozilla_entwickeln	/docs/de/Entwicklerhandbuch
/de/docs/Neuste_Version	/de/docs/Mozilla/Developer_guide/Quelltexte/Mozilla_Quelltexte_herunterladen
/de/docs/Online_and_offline_events	/de/docs/Web/API/NavigatorOnLine/Online_and_offline_events
/de/docs/Open_Web_apps_and_Web_standards	/de/docs/Archive/B2G_OS/Quickstart/Open_Web_apps_and_Web_standards
/de/docs/Persona	/de/docs/Mozilla/Persona
/de/docs/Persona/Bootstrapping_Persona	/de/docs/Mozilla/Persona/Bootstrapping_Persona
/de/docs/Persona/Browser_compatibility	/de/docs/Mozilla/Persona/Browser_compatibility
/de/docs/Persona/Protocol_Overview	/de/docs/Mozilla/Persona/Protocol_Overview
/de/docs/Persona/Schnellstart	/de/docs/Mozilla/Persona/Schnellstart
/de/docs/Persona/Warum_Persona	/de/docs/Mozilla/Persona/Warum_Persona
/de/docs/Profilmanager	/de/docs/Profile_Manager
/de/docs/Project:About	/de/docs/MDN/Über
/de/docs/Project:Copyright	/docs/Project:de/Copyrights
/de/docs/Project:Feedback	/de/docs/MDN/Feedback
/de/docs/Project:Kontaktliste	/de/docs/MDN/Community
/de/docs/Project:MDN/About	/de/docs/MDN/About
/de/docs/Project:MDN/Contributing/Der_beste_Browser_ist_Firefox	/de/docs/MDN/Community/Bleibe_auf_dem_Laufenden
/de/docs/Project:MDN/Contributing/Editoren_Anleitung	/de/docs/MDN/Contribute/Editoren_Anleitung
/de/docs/Project:MDN/Contributing/Editoren_Anleitung/Basics	/de/docs/MDN/Contribute/Editoren_Anleitung/Basics
/de/docs/Project:MDN/Contributing/Join_the_community	/de/docs/MDN/Community
/de/docs/Project:Urheberrecht	/de/docs/MDN/Über
/de/docs/Project:Wie_kann_ich_helfen	/docs/Project:de/Wie_kann_ich_helfen?
/de/docs/Project:Wie_kannst_du_helfen	/docs/Project:de/Wie_kann_ich_helfen?
/de/docs/Project:de	/de/docs/MDN
/de/docs/Project:Über_Devmo_De	/docs/Project:de/%C3%9Cber_das_Mozilla_Developer_Center
/de/docs/Project:Über_MDC	/docs/Project:de/%C3%9Cber_das_Mozilla_Developer_Center
/de/docs/QA	/de/docs/Mozilla/QA
/de/docs/QA/Stress_Testing	/docs/de/Qualit%C3%A4tssicherung/Stress_Testing
/de/docs/QA:Stress_Testing	/docs/de/QA/Stress_Testing
/de/docs/Qualitätssicherung	/de/docs/Mozilla/QA
/de/docs/RDF_in_Mozilla_FAQ	/de/docs/Archive/Web-Standards/RDF_in_Mozilla_FAQ
/de/docs/RSS	/de/docs/Archive/RSS
/de/docs/SVG	/de/docs/Web/SVG
/de/docs/SVG/Element	/de/docs/Web/SVG/Element
/de/docs/SVG/Element/animate	/de/docs/Web/SVG/Element/animate
/de/docs/SVG/Element/foreignObject	/de/docs/Web/SVG/Element/foreignObject
/de/docs/SVG/Element/image	/de/docs/Web/SVG/Element/image
/de/docs/SVG/Tutorial	/de/docs/Web/SVG/Tutorial
/de/docs/SVG/Tutorial/Einführung	/de/docs/Web/SVG/Tutorial/Einf%C3%BChrung
/de/docs/SVG_In_HTML_Introduction	/de/docs/Web/SVG/Tutorial/SVG_In_HTML_Introduction
/de/docs/Sandbox/background-blend-mode	/de/docs/Web/CSS/background-blend-mode
/de/docs/Sandbox:Test_Page	/docs/de/Sandbox/Test_Page
/de/docs/SeaMonkey_mit_VC8_Express_Kompilieren	/docs/de/Entwicklerhandbuch/Build_Anweisungen/Windows_Build_Voraussetzungen
/de/docs/SeaMonkey_mit_VC_8_Express_Kompilieren	/docs/de/Entwicklerhandbuch/Build_Anweisungen/Windows_Build_Voraussetzungen
/de/docs/Simple_Firefox_build	/de/docs/Mozilla/Developer_guide/Build_Anweisungen/Simple_Firefox_build
/de/docs/Simple_Firefox_build/Linux_and_MacOS_build_preparation	/de/docs/Mozilla/Developer_guide/Build_Anweisungen/Simple_Firefox_build/Linux_and_MacOS_build_preparation
/de/docs/Suche_Plugins	/de/docs/OpenSearch_Plugin_für_Firefox_erstellen
/de/docs/Theme_erstellen:Einführung	/docs/de/Theme_erstellen/Einf%C3%BChrung
/de/docs/Theme_erstellen:UUID	/docs/de/Theme_erstellen/UUID
/de/docs/Theme_erstellen:contents.rdf	/docs/de/Theme_erstellen/contents.rdf
/de/docs/Theme_erstellen:install.rdf	/docs/de/Theme_erstellen/install.rdf
/de/docs/Themen	/de/docs/Themes
/de/docs/Thunderbird	/de/docs/Mozilla/Thunderbird
/de/docs/Tinderbox	/de/docs/Archive/Mozilla/Tinderbox
/de/docs/Tools/Firefox_OS_Simulator	/de/docs/Archive/B2G_OS/Simulator
/de/docs/Tools/Seiten_Inspektor/Style_panel	/de/docs/Tools/Seiten_Inspektor
/de/docs/Verwenden_des_Cache_beim_Firefox_1.5	/docs/de/Benutzen_des_Zwischenspeichers_in_Firefox_1.5_(caching)
/de/docs/Web-Standards	/de/docs/Archive/Web-Standards
/de/docs/Web/API/CSSRule.cssText	/de/docs/Web/API/CSSRule/cssText
/de/docs/Web/API/Element.querySelector	/de/docs/Web/API/Element/querySelector
/de/docs/Web/API/File/size	/de/docs/Web/API/Blob/size
/de/docs/Web/API/MozMobileConnection.selectNetworkAutomatically	/de/docs/Web/API/MozMobileConnection/selectNetworkAutomatically
/de/docs/Web/API/Navigator/requestWakeLock	/de/docs/Archive/B2G_OS/API/Navigator/requestWakeLock
/de/docs/Web/API/Node.cloneNode	/de/docs/Web/API/Node/cloneNode
/de/docs/Web/API/WebGL_API/3D-Objekte_mit_WebGL_erstellen	/de/docs/Web/API/WebGL_API/Tutorial/3D-Objekte_mit_WebGL_erstellen
/de/docs/Web/API/WebGL_API/Animierte_Texturen_in_WebGL	/de/docs/Web/API/WebGL_API/Tutorial/Animierte_Texturen_in_WebGL
/de/docs/Web/API/WebGL_API/Beleuchtung_in_WebGL	/de/docs/Web/API/WebGL_API/Tutorial/Beleuchtung_in_WebGL
/de/docs/Web/API/WebGL_API/Einführung_in_WebGL	/de/docs/Web/API/WebGL_API/Tutorial/Einf%C3%BChrung_in_WebGL
/de/docs/Web/API/WebGL_API/Farben_mittels_Shader_in_einen_WebGL-Kontext_hinzufügen	/de/docs/Web/API/WebGL_API/Tutorial/Farben_mittels_Shader_in_einen_WebGL-Kontext_hinzuf%C3%BCgen
/de/docs/Web/API/WebGL_API/Hinzufügen_von_2D_Inhalten_in_einen_WebGL-Kontext	/de/docs/Web/API/WebGL_API/Tutorial/Hinzuf%C3%BCgen_von_2D_Inhalten_in_einen_WebGL-Kontext
/de/docs/Web/API/WebGL_API/Objekte_mit_WebGL_animieren	/de/docs/Web/API/WebGL_API/Tutorial/Objekte_mit_WebGL_animieren
/de/docs/Web/API/WebGL_API/Texturen_in_WebGL_verwenden	/de/docs/Web/API/WebGL_API/Tutorial/Texturen_in_WebGL_verwenden
/de/docs/Web/API/Window.alert	/de/docs/Web/API/Window/alert
/de/docs/Web/API/Window/setTimeout	/de/docs/Web/API/WindowTimers/setTimeout
/de/docs/Web/API/document.documentElement	/de/docs/Web/API/Document/documentElement
/de/docs/Web/Apps/Developing/Packaged_apps	/de/Marketplace/Publishing/Packaged_apps
/de/docs/Web/Apps/Quickstart/Build	/de/docs/Archive/B2G_OS/Quickstart
/de/docs/Web/Apps/Quickstart/Build/Einfuerung_zu_Firefox_OS	/de/docs/Archive/B2G_OS/Quickstart/Einfuerung_zu_Firefox_OS
/de/docs/Web/Apps/Quickstart/Build/For_mobile_developers	/de/docs/Archive/B2G_OS/Quickstart/For_mobile_developers
/de/docs/Web/Apps/Quickstart/Build/deine_erste_app	/de/docs/Archive/B2G_OS/Quickstart/deine_erste_app
/de/docs/Web/Apps/Quickstart/Publish/App_publishing_options	/de/Marketplace/Publishing/Publish_options
/de/docs/Web/CSS/-moz-alias	/de/docs/Web/CSS/cursor
/de/docs/Web/CSS/-moz-appearance	/de/docs/Web/CSS/appearance
/de/docs/Web/CSS/-moz-background-inline-policy	/de/docs/Web/CSS/box-decoration-break
/de/docs/Web/CSS/-moz-border-radius	/docs/de/CSS/border-radius
/de/docs/Web/CSS/-moz-border-radius-bottomleft	/docs/de/CSS/border-bottom-left-radius
/de/docs/Web/CSS/-moz-border-radius-bottomright	/docs/de/CSS/border-bottom-right-radius
/de/docs/Web/CSS/-moz-border-radius-topleft	/docs/de/CSS/border-top-left-radius
/de/docs/Web/CSS/-moz-border-radius-topright	/docs/de/CSS/border-top-right-radius
/de/docs/Web/CSS/-moz-box-shadow	/docs/de/CSS/box-shadow
/de/docs/Web/CSS/-moz-context-menu	/de/docs/Web/CSS/cursor
/de/docs/Web/CSS/-moz-copy	/de/docs/Web/CSS/cursor
/de/docs/Web/CSS/-moz-spinning	/de/docs/Web/CSS/cursor
/de/docs/Web/CSS/-webkit-mask-position	/de/docs/Web/CSS/mask-position
/de/docs/Web/CSS/Adjacent_sibling_combinator	/de/docs/Web/CSS/Angrenzende_Geschwisterselektoren
/de/docs/Web/CSS/Adjacent_sibling_selectors	/de/docs/Web/CSS/Adjacent_sibling_combinator
/de/docs/Web/CSS/Boxmodell	/de/docs/Web/CSS/CSS_Boxmodell/Einf%C3%BChrung_in_das_CSS_Boxmodell
/de/docs/Web/CSS/CSS3	/de/docs/Archive/CSS3
/de/docs/Web/CSS/CSS_Box_Model	/de/docs/Web/CSS/CSS_Boxmodell
/de/docs/Web/CSS/CSS_Box_Model/Box-shadow_generator	/de/docs/Web/CSS/CSS_Boxmodell/Box-shadow_generator
/de/docs/Web/CSS/CSS_Referenz/::backdrop	/de/docs/Web/CSS/::backdrop
/de/docs/Web/CSS/CSS_Referenz/<basic-shape>	/de/docs/Web/CSS/basic-shape
/de/docs/Web/CSS/CSS_Referenz/@viewport	/de/docs/Web/CSS/@viewport
/de/docs/Web/CSS/CSS_Referenz/Mozilla_CSS_Erweiterungen	/de/docs/Web/CSS/Mozilla_Extensions
/de/docs/Web/CSS/CSS_Referenz/Webkit_Extensions	/de/docs/Web/CSS/WebKit_Extensions
/de/docs/Web/CSS/CSS_Referenz/line-break	/de/docs/Web/CSS/line-break
/de/docs/Web/CSS/CSS_Referenz/mix-blend-mode	/de/docs/Web/CSS/mix-blend-mode
/de/docs/Web/CSS/CSS_Werte_Geltung	/de/docs/Web/CSS
/de/docs/Web/CSS/CSS_animierbare_Eigenschaften	/de/docs/Web/CSS
/de/docs/Web/CSS/CSS_prozentuale_werte	/de/docs/Web/CSS
/de/docs/Web/CSS/CSS_werte_syntax	/de/docs/Web/CSS
/de/docs/Web/CSS/Child_selectors	/de/docs/Web/CSS/Kindselektoren
/de/docs/Web/CSS/Getting_Started	/de/docs/Web/Guide/CSS/Getting_started
/de/docs/Web/CSS/Pseudoklasse	/de/docs/Web/CSS/Pseudo-classes
/de/docs/Web/CSS/Referenz	/de/docs/Web/CSS/CSS_Referenz
/de/docs/Web/CSS/Replaced_element	/de/docs/Web/CSS/ersetztes_Element
/de/docs/Web/CSS/azimuth	/docs/De/CSS/Refrerenz/Azimuth
/de/docs/Web/CSS/hidden	/de/docs/Web/CSS/visibility
/de/docs/Web/CSS/laenge	/docs/de/CSS/Einheiten
/de/docs/Web/CSS/marks	/de/docs/Web/CSS/%40page/marks
/de/docs/Web/CSS/mq-boolean	/de/docs/Web/CSS/Media_Queries/Using_media_queries
/de/docs/Web/CSS/text-shadow/text-shadow	/docs/User:Elchi3/text-shadow
/de/docs/Web/CSS/visible	/de/docs/Web/CSS/visibility
/de/docs/Web/Events/fullscreenchange	/de/docs/Web/API/Document/fullscreenchange_event
/de/docs/Web/Events/popstate	/de/docs/Web/API/Window/popstate_event
/de/docs/Web/Events/submit	/de/docs/Web/API/HTMLFormElement/submit_event
/de/docs/Web/Events/touchstart	/de/docs/Web/API/Element/touchstart_event
/de/docs/Web/Events/webglcontextcreationerror	/de/docs/Web/API/HTMLCanvasElement/webglcontextcreationerror_event
/de/docs/Web/Events/webglcontextlost	/de/docs/Web/API/HTMLCanvasElement/webglcontextlost_event
/de/docs/Web/Events/webglcontextrestored	/de/docs/Web/API/HTMLCanvasElement/webglcontextrestored_event
/de/docs/Web/Guide/AJAX/Getting_Started	/docs/de/AJAX/Einf%C3%BChrung
/de/docs/Web/Guide/CSS	/de/docs/Learn/CSS
/de/docs/Web/Guide/CSS/CSS_Animationen_nutzen	/de/docs/Web/CSS/CSS_Animations/CSS_Animationen_nutzen
/de/docs/Web/Guide/CSS/Flexible_boxes	/de/docs/Web/CSS/CSS_Flexible_Box_Layout/Using_CSS_flexible_boxes
/de/docs/Web/Guide/CSS/mehrere_Hintergründe_verwenden	/de/docs/Web/CSS/CSS_Background_and_Borders/Mehrere_Hintergr%C3%BCnde_in_CSS_verwenden
/de/docs/Web/Guide/HTML	/de/docs/Learn/HTML
/de/docs/Web/Guide/HTML/Einführung	/de/docs/Learn/HTML/Einf%C3%BChrung_in_HTML
/de/docs/Web/HTML/Element/Schaltfläche	/de/docs/Web/HTML/Element/button
/de/docs/Web/HTML/Element/h1	/de/docs/Web/HTML/Element/h1-h6
/de/docs/Web/HTML/Element/h2	/de/docs/Web/HTML/Element/h1-h6
/de/docs/Web/HTML/Element/h3	/de/docs/Web/HTML/Element/h1-h6
/de/docs/Web/HTML/Element/h4	/de/docs/Web/HTML/Element/h1-h6
/de/docs/Web/HTML/Element/h5	/de/docs/Web/HTML/Element/h1-h6
/de/docs/Web/HTML/Element/h6	/de/docs/Web/HTML/Element/h1-h6
/de/docs/Web/HTML/HTML_Lernen_für_Anfänger	/docs/de/HTML/HTML//beginner
/de/docs/Web/JavaScript/Datenstruktures	/de/docs/Web/JavaScript/Datenstrukturen
/de/docs/Web/JavaScript/Getting_Started	/de/Learn/Getting_started_with_the_web/JavaScript_basics
/de/docs/Web/JavaScript/Guide/Closures	/de/docs/Web/JavaScript/Closures
/de/docs/Web/JavaScript/Guide/Statements	/de/docs/Web/JavaScript/Guide/Kontrollfluss_und_Fehlerbehandlung
/de/docs/Web/JavaScript/Guide/Ueber_JavaScript	/de/docs/Web/JavaScript/Guide/Einführung
/de/docs/Web/JavaScript/Guide/Ueber_diese_Einfuehrung	/de/docs/JavaScript/Guide/Über_diese_Einführung
/de/docs/Web/JavaScript/Guide/Vererbung_ueberdacht	/de/docs/Web/JavaScript/Inheritance_and_the_prototype_chain
/de/docs/Web/JavaScript/Guide/Vergleiche_auf_Gleichheit_und_deren_Verwendung	/de/docs/Web/JavaScript/Vergleiche_auf_Gleichheit_und_deren_Verwendung
/de/docs/Web/JavaScript/Guide/Vordefinierte_Kernobjekte	/de/docs/Web/JavaScript/Guide
/de/docs/Web/JavaScript/Guide/Werte_Variablen_und_Literale	/de/docs/Web/JavaScript/Guide/Grammatik_und_Typen
/de/docs/Web/JavaScript/Guide/Über_Javascript	/docs/de/JavaScript/javascript_guide/%C3%9Cber_Javascript
/de/docs/Web/JavaScript/Guide/Über_diese_Einführung	/de/docs/Web/JavaScript/Guide/Einführung
/de/docs/Web/JavaScript/Javascript_lernen_für_Anfänger	/docs/de/JavaScript/javascript_guide
/de/docs/Web/JavaScript/Neu_in_JavaScript/ECMAScript_7_support_in_Mozilla	/de/docs/Archive/Web/JavaScript/ECMAScript_7_support_in_Mozilla
/de/docs/Web/JavaScript/Reference/Anweisungen	/de/docs/Web/JavaScript/Reference/Statements
/de/docs/Web/JavaScript/Reference/Anweisungen/const	/de/docs/Web/JavaScript/Reference/Statements/const
/de/docs/Web/JavaScript/Reference/Anweisungen/for...in	/de/docs/Web/JavaScript/Reference/Statements/for...in
/de/docs/Web/JavaScript/Reference/Anweisungen/let	/de/docs/Web/JavaScript/Reference/Statements/let
/de/docs/Web/JavaScript/Reference/Anweisungen/var	/de/docs/Web/JavaScript/Reference/Statements/var
/de/docs/Web/JavaScript/Reference/Global_Objects/Array/flatten	/de/docs/Web/JavaScript/Reference/Global_Objects/Array/flat
/de/docs/Web/JavaScript/Tutorials	/de/docs/Web/JavaScript
/de/docs/Web/JavaScript/java_guide	/docs/de/JavaScript/javascript_guide
/de/docs/Web/JavaScript/javascript_guide	/de/docs/JavaScript/Guide
/de/docs/Web/JavaScript/javascript_guide/Ausdrücke_und_Operatoren	/de/docs/JavaScript/Guide/Ausdruecke_und_Operatoren
/de/docs/Web/JavaScript/javascript_guide/Javascript_Übersicht	/docs/de/JavaScript/javascript_guide/%C3%9Cber_Javascript
/de/docs/Web/JavaScript/javascript_guide/Werte,_Variable_und_Literale	/docs/de/JavaScript/javascript_guide/Werte,_Variablen_und_Literale
/de/docs/Web/JavaScript/javascript_guide/Werte,_Variablen_und_Literale	/de/docs/JavaScript/Guide/Werte_Variablen_und_Literale
/de/docs/Web/JavaScript/javascript_guide/ueber_javascript	/de/docs/JavaScript/Guide/Ueber_JavaScript
/de/docs/Web/JavaScript/javascript_guide/ueber_javascript/Über_Javascript	/docs/de/JavaScript/javascript_guide/%C3%9Cber_Javascript
/de/docs/Web/JavaScript/javascript_guide/Über_Javascript	/de/docs/JavaScript/Guide/Ueber_JavaScript
/de/docs/Web/JavaScript/javascript_guide/Über_diese_Einführung	/de/docs/JavaScript/Guide/Ueber_diese_Einfuehrung
/de/docs/Web/JavaScript/ueber_JavaScript	/de/docs/JavaScript/Guide/Ueber_JavaScript
/de/docs/Web/JavaScript/ueber_JavaScript/Über_Javascript	/docs/de/JavaScript/javascript_guide/%C3%9Cber_Javascript
/de/docs/Web/JavaScript/Über_Javascript	/docs/de/JavaScript/javascript_guide/%C3%9Cber_Javascript
/de/docs/Web/WebGL	/de/docs/Web/API/WebGL_API
/de/docs/Web/WebGL/3D-Objekte_mit_WebGL_erstellen	/de/docs/Web/API/WebGL_API/3D-Objekte_mit_WebGL_erstellen
/de/docs/Web/WebGL/Animierte_Texturen_in_WebGL	/de/docs/Web/API/WebGL_API/Animierte_Texturen_in_WebGL
/de/docs/Web/WebGL/Beleuchtung_in_WebGL	/de/docs/Web/API/WebGL_API/Beleuchtung_in_WebGL
/de/docs/Web/WebGL/Einführung_in_WebGL	/de/docs/Web/API/WebGL_API/Einf%C3%BChrung_in_WebGL
/de/docs/Web/WebGL/Farben_mittels_Shader_in_einen_WebGL-Kontext_hinzufügen	/de/docs/Web/API/WebGL_API/Farben_mittels_Shader_in_einen_WebGL-Kontext_hinzuf%C3%BCgen
/de/docs/Web/WebGL/Hinzufügen_von_2D_Inhalten_in_einen_WebGL-Kontext	/de/docs/Web/API/WebGL_API/Hinzuf%C3%BCgen_von_2D_Inhalten_in_einen_WebGL-Kontext
/de/docs/Web/WebGL/Objekte_mit_WebGL_animieren	/de/docs/Web/API/WebGL_API/Objekte_mit_WebGL_animieren
/de/docs/Web/WebGL/Texturen_in_WebGL_verwenden	/de/docs/Web/API/WebGL_API/Texturen_in_WebGL_verwenden
/de/docs/WebGL	/de/docs/Web/WebGL
/de/docs/WebGL/3D-Objekte_mit_WebGL_erstellen	/de/docs/Web/WebGL/3D-Objekte_mit_WebGL_erstellen
/de/docs/WebGL/Animierte_Texturen_in_WebGL	/de/docs/Web/WebGL/Animierte_Texturen_in_WebGL
/de/docs/WebGL/Beleuchtung_in_WebGL	/de/docs/Web/WebGL/Beleuchtung_in_WebGL
/de/docs/WebGL/Einführung_in_WebGL	/de/docs/Web/WebGL/Einf%C3%BChrung_in_WebGL
/de/docs/WebGL/Farben_mittels_Shader_in_einen_WebGL-Kontext_hinzufügen	/de/docs/Web/WebGL/Farben_mittels_Shader_in_einen_WebGL-Kontext_hinzuf%C3%BCgen
/de/docs/WebGL/Hinzufügen_von_2D_Inhalten_in_einen_WebGL-Kontext	/de/docs/Web/WebGL/Hinzuf%C3%BCgen_von_2D_Inhalten_in_einen_WebGL-Kontext
/de/docs/WebGL/Objekte_mit_WebGL_animieren	/de/docs/Web/WebGL/Objekte_mit_WebGL_animieren
/de/docs/WebGL/Texturen_in_WebGL_verwenden	/de/docs/Web/WebGL/Texturen_in_WebGL_verwenden
/de/docs/Web_Standards	/docs/de/Web-Standards
/de/docs/Webbasierte_protokoll-handler	/de/docs/Web/API/Navigator/registerProtocolHandler/Webbasierte_protokoll-handler
/de/docs/Werkzeuge	/de/docs/Tools
/de/docs/XML_Einführung	/de/docs/Web/XML/XML_Einf%C3%BChrung
/de/docs/XSLT	/de/docs/Web/XSLT
/de/docs/XUL	/de/docs/Mozilla/Tech/XUL
/de/docs/XUL-Referenz	/de/docs/Mozilla/Tech/XUL/XUL_Referenz
/de/docs/XUL/Arrowscrollbox	/de/docs/Mozilla/Tech/XUL/Arrowscrollbox
/de/docs/XUL/Assign	/de/docs/Mozilla/Tech/XUL/Assign
/de/docs/XUL/Attribute	/de/docs/Mozilla/Tech/XUL/Attribute
/de/docs/XUL/Attribute/Activetitlebarcolor	/de/docs/Mozilla/Tech/XUL/Attribute/Activetitlebarcolor
/de/docs/XUL/Attribute/Color	/de/docs/Mozilla/Tech/XUL/Attribute/Color
/de/docs/XUL/Attribute/Cols	/de/docs/Mozilla/Tech/XUL/Attribute/Cols
/de/docs/XUL/Attribute/Decimalplaces	/de/docs/Mozilla/Tech/XUL/Attribute/Decimalplaces
/de/docs/XUL/Attribute/Disabled	/de/docs/Mozilla/Tech/XUL/Attribute/Disabled
/de/docs/XUL/Attribute/Empty	/de/docs/Mozilla/Tech/XUL/Attribute/Empty
/de/docs/XUL/Attribute/Emptytext	/de/docs/Mozilla/Tech/XUL/Attribute/Emptytext
/de/docs/XUL/Attribute/Expr	/de/docs/Mozilla/Tech/XUL/Attribute/Expr
/de/docs/XUL/Attribute/Hidespinbuttons	/de/docs/Mozilla/Tech/XUL/Attribute/Hidespinbuttons
/de/docs/XUL/Attribute/Onchange	/de/docs/Mozilla/Tech/XUL/Attribute/Onchange
/de/docs/XUL/Attribute/Var	/de/docs/Mozilla/Tech/XUL/Attribute/Var
/de/docs/XUL/Attribute/accesskey	/de/docs/Mozilla/Tech/XUL/Attribute/accesskey
/de/docs/XUL/Attribute/align	/de/docs/Mozilla/Tech/XUL/Attribute/align
/de/docs/XUL/Attribute/allowevents	/de/docs/Mozilla/Tech/XUL/Attribute/allowevents
/de/docs/XUL/Attribute/allownegativeassertions	/de/docs/Mozilla/Tech/XUL/Attribute/allownegativeassertions
/de/docs/XUL/Attribute/label	/de/docs/Mozilla/Tech/XUL/Attribute/label
/de/docs/XUL/Attribute/prefpane.src	/de/docs/Mozilla/Tech/XUL/Attribute/prefpane.src
/de/docs/XUL/Attribute/src	/de/docs/Mozilla/Tech/XUL/Attribute/src
/de/docs/XUL/Attribute/treecell.src	/de/docs/Mozilla/Tech/XUL/Attribute/treecell.src
/de/docs/XUL/Attribute/treecol.src	/de/docs/Mozilla/Tech/XUL/Attribute/treecol.src
/de/docs/XUL/Bbox	/de/docs/Mozilla/Tech/XUL/Bbox
/de/docs/XUL/Binding	/de/docs/Mozilla/Tech/XUL/Binding
/de/docs/XUL/Box	/de/docs/Mozilla/Tech/XUL/Box
/de/docs/XUL/Colorpicker	/de/docs/Mozilla/Tech/XUL/Colorpicker
/de/docs/XUL/Eigenschaften	/de/docs/Mozilla/Tech/XUL/Eigenschaften
/de/docs/XUL/Events	/de/docs/Mozilla/Tech/XUL/Events
/de/docs/XUL/Method	/de/docs/Mozilla/Tech/XUL/Method
/de/docs/XUL/Method/getIcon	/de/docs/Mozilla/Tech/XUL/Method/getIcon
/de/docs/XUL/Method/getTabForBrowser	/de/docs/Mozilla/Tech/XUL/Method/getTabForBrowser
/de/docs/XUL/Property	/de/docs/Mozilla/Tech/XUL/Property
/de/docs/XUL/School_tutorial	/de/docs/Mozilla/Tech/XUL/School_tutorial
/de/docs/XUL/School_tutorial/Die_Grundlagen_einer_Erweiterung	/de/docs/Mozilla/Tech/XUL/School_tutorial/Die_Grundlagen_einer_Erweiterung
/de/docs/XUL/School_tutorial/Eine_Entwicklungsumgebung_einrichten_Environment	/de/docs/Mozilla/Tech/XUL/School_tutorial/Eine_Entwicklungsumgebung_einrichten_Environment
/de/docs/XUL/School_tutorial/Einleitung	/de/docs/Mozilla/Tech/XUL/School_tutorial/Einleitung
/de/docs/XUL/School_tutorial/Getting_Started_with_Firefox_Extensions	/de/docs/Mozilla/Tech/XUL/School_tutorial/Getting_Started_with_Firefox_Extensions
/de/docs/XUL/Style	/de/docs/Mozilla/Tech/XUL/Style
/de/docs/XUL/Style/treecol-image	/de/docs/Mozilla/Tech/XUL/Style/treecol-image
/de/docs/XUL/Textbox	/de/docs/Mozilla/Tech/XUL/Textbox
/de/docs/XUL/Window	/de/docs/Mozilla/Tech/XUL/Window
/de/docs/XUL/action	/de/docs/Mozilla/Tech/XUL/action
/de/docs/XUL/grippy	/de/docs/Mozilla/Tech/XUL/grippy
/de/docs/XUL/iframe	/de/docs/Mozilla/Tech/XUL/iframe
/de/docs/XUL/separator	/de/docs/Mozilla/Tech/XUL/separator
/de/docs/XUL/spacer	/de/docs/Mozilla/Tech/XUL/spacer
/de/docs/XUL/splitter	/de/docs/Mozilla/Tech/XUL/splitter
/de/docs/XUL/tab	/de/docs/Mozilla/Tech/XUL/tab
/de/docs/XUL/tabbox	/de/docs/Mozilla/Tech/XUL/tabbox
/de/docs/XUL/tabpanels	/de/docs/Mozilla/Tech/XUL/tabpanels
/de/docs/XUL/tabs	/de/docs/Mozilla/Tech/XUL/tabs
/de/docs/XUL/treecol	/de/docs/Mozilla/Tech/XUL/treecol
/de/docs/XUL/vbox	/de/docs/Mozilla/Tech/XUL/vbox
/de/docs/XUL:Attribute	/docs/de/XUL/Attribute
/de/docs/XUL:Attribute:accesskey	/docs/de/XUL/Attribute/accesskey
/de/docs/XUL:Attribute:align	/docs/de/XUL/Attribute/align
/de/docs/XUL:Attribute:allowevents	/docs/de/XUL/Attribute/allowevents
/de/docs/XUL:Attribute:allownegativeassertions	/docs/de/XUL/Attribute/allownegativeassertions
/de/docs/XUL:Attribute:label	/docs/de/XUL/Attribute/label
/de/docs/XUL:Attribute:prefpane.src	/docs/de/XUL/Attribute/prefpane.src
/de/docs/XUL:Attribute:src	/docs/de/XUL/Attribute/src
/de/docs/XUL:Attribute:treecell.src	/docs/de/XUL/Attribute/treecell.src
/de/docs/XUL:Attribute:treecol.src	/docs/de/XUL/Attribute/treecol.src
/de/docs/XUL:Events	/docs/de/XUL/Events
/de/docs/XUL:Method	/docs/de/XUL/Method
/de/docs/XUL:Property	/docs/de/XUL/Property
/de/docs/XUL:Style:treecol-image	/docs/de/XUL/Style/treecol-image
/de/docs/XUL:action	/docs/de/XUL/action
/de/docs/XUL:grippy	/docs/de/XUL/grippy
/de/docs/XUL:iframe	/docs/de/XUL/iframe
/de/docs/XUL:separator	/docs/de/XUL/separator
/de/docs/XUL:spacer	/docs/de/XUL/spacer
/de/docs/XUL:splitter	/docs/de/XUL/splitter
/de/docs/XUL:tab	/docs/de/XUL/tab
/de/docs/XUL:tabbox	/docs/de/XUL/tabbox
/de/docs/XUL:tabpanels	/docs/de/XUL/tabpanels
/de/docs/XUL:tabs	/docs/de/XUL/tabs
/de/docs/XUL:treecol	/docs/de/XUL/treecol
/de/docs/XUL:vbox	/docs/de/XUL/vbox
/de/docs/XULRunner	/de/docs/Archive/Mozilla/XULRunner
/de/docs/XUL_Beispiel	/de/docs/Mozilla/Tech/XUL
/de/docs/XUL_Einführung	/de/docs/Mozilla/Tech/XUL/XUL_Tutorial
/de/docs/XUL_Einführung/Lokalisierung	/docs/de/XUL_Tutorial/Lokalisierung
/de/docs/XUL_Einführung:Lokalisierung	/docs/de/XUL_Einf%C3%BChrung/Lokalisierung
/de/docs/XUL_Referenz	/de/docs/Mozilla/Tech/XUL/XUL_Referenz
/de/docs/XUL_School/Adding_menus_and_submenus	/de/docs/Mozilla/Tech/XUL/School_tutorial/Adding_menus_and_submenus
/de/docs/XUL_Tutorial	/de/docs/Mozilla/Tech/XUL/XUL_Tutorial
/de/docs/XUL_Tutorial/Die_Chrome-URL	/de/docs/Mozilla/Tech/XUL/XUL_Tutorial/Die_Chrome-URL
/de/docs/XUL_Tutorial/Die_Chrome_URL	/de/docs/Mozilla/Tech/XUL/XUL_Tutorial/Die_Chrome_URL
/de/docs/XUL_Tutorial/Ein_Fenster_erzeugen	/de/docs/Mozilla/Tech/XUL/XUL_Tutorial/Ein_Fenster_erzeugen
/de/docs/XUL_Tutorial/Einfuehrung	/de/docs/Mozilla/Tech/XUL/XUL_Tutorial/Einfuehrung
/de/docs/XUL_Tutorial/Installations-Skripte	/de/docs/Mozilla/Tech/XUL/XUL_Tutorial/Installations-Skripte
/de/docs/XUL_Tutorial/Lokalisierung	/de/docs/Mozilla/Tech/XUL/XUL_Tutorial/Lokalisierung
/de/docs/XUL_Tutorial/Positionierung_von_Elementen	/de/docs/Mozilla/Tech/XUL/XUL_Tutorial/Positionierung_von_Elementen
/de/docs/XUL_Tutorial/XUL_Struktur	/de/docs/Mozilla/Tech/XUL/XUL_Tutorial/XUL_Struktur
/de/docs/XUL_Tutorial:Die_Chrome-URL	/docs/de/XUL_Tutorial/Die_Chrome-URL
/de/docs/XUL_Tutorial:Ein_Fenster_erzeugen	/docs/de/XUL_Tutorial/Ein_Fenster_erzeugen
/de/docs/XUL_Tutorial:Einfuehrung	/docs/de/XUL_Tutorial/Einfuehrung
/de/docs/XUL_Tutorial:Positionierung_von_Elementen	/docs/de/XUL_Tutorial/Positionierung_von_Elementen
/de/docs/XUL_Tutorial:XUL_Struktur	/docs/de/XUL_Tutorial/XUL_Struktur
/de/docs/Zugriff_auf_Dateien_von_Webapplikationen	/de/docs/Web/API/File/Zugriff_auf_Dateien_von_Webapplikationen
/de/docs/en	/
/de/docs/install.rdf	/docs/de/Installationsmanifest
/de/docs/meta:Help:External_editors	/docs/de/meta/Help/External_editors
/de/docs/persona/branding	/de/docs/Mozilla/Persona/branding
/de/docs/Änderungen_an_XUL_für_Firefox_1.5	/de/docs/Archive/Mozilla/XUL/%C3%84nderungen_an_XUL_f%C3%BCr_Firefox_1.5
/de/docs/Über_das_Mozilla_Developer_Center	/docs/Project:de/%C3%9Cber_das_Mozilla_Developer_Center
