# FROM-URL	TO-URL
/it/docs/AJAX	/it/docs/Web/Guide/AJAX
/it/docs/AJAX/Iniziare	/it/docs/Web/Guide/AJAX/Iniziare
/it/docs/AJAX:Iniziare	/docs/it/AJAX/Iniziare
/it/docs/Applicazioni_basate_su_XULRunner	/it/docs/Archive/Mozilla/XULRunner/Applicazioni_basate_su_XULRunner
/it/docs/Archive/B2G_OS/Developer_phone_guide	/it/docs/Archive/B2G_OS/Phone_guide
/it/docs/Archive/B2G_OS/Developer_phone_guide/Fairphone	/it/docs/Archive/B2G_OS/Phone_guide/Fairphone
/it/docs/Archive/B2G_OS/Developer_phone_guide/Flame	/it/docs/Archive/B2G_OS/Phone_guide/Flame
/it/docs/Archive/B2G_OS/Developer_phone_guide/Geeksphone	/it/docs/Archive/B2G_OS/Phone_guide/Geeksphone
/it/docs/Archive/B2G_OS/Developer_phone_guide/Specifiche_telefoni_dispositivi	/it/docs/Archive/B2G_OS/Phone_guide/Specifiche_telefoni_dispositivi
/it/docs/Archive/B2G_OS/Developer_phone_guide/ZTE_OPEN	/it/docs/Archive/B2G_OS/Phone_guide/ZTE_OPEN
/it/docs/Archive/B2G_OS/Developer_phone_guide/ZTE_OPEN_C	/it/docs/Archive/B2G_OS/Phone_guide/ZTE_OPEN_C
/it/docs/Archive/B2G_OS/Platform/Automated_testing	/it/docs/Archive/B2G_OS/Automated_testing
/it/docs/CSS	/it/docs/Web/CSS
/it/docs/CSS/-moz-font-language-override	/it/docs/Web/CSS/-moz-font-language-override
/it/docs/CSS/:-moz-first-node	/it/docs/Web/CSS/:-moz-first-node
/it/docs/CSS/:-moz-last-node	/it/docs/Web/CSS/:-moz-last-node
/it/docs/CSS/:-moz-list-bullet	/it/docs/Web/CSS/:-moz-list-bullet
/it/docs/CSS/@-moz-document	/it/docs/Web/CSS/@-moz-document
/it/docs/CSS/Getting_Started	/it/docs/Web/CSS/Getting_Started
/it/docs/CSS/Mozilla_Extensions	/it/docs/Web/CSS/Mozilla_Extensions
/it/docs/CSS/background	/it/docs/Web/CSS/background
/it/docs/CSS/background-attachment	/it/docs/Web/CSS/background-attachment
/it/docs/CSS/background-color	/it/docs/Web/CSS/background-color
/it/docs/CSS/background-image	/it/docs/Web/CSS/background-image
/it/docs/CSS/background-position	/it/docs/Web/CSS/background-position
/it/docs/CSS/background-repeat	/it/docs/Web/CSS/background-repeat
/it/docs/CSS/border	/it/docs/Web/CSS/border
/it/docs/CSS/border-bottom	/it/docs/Web/CSS/border-bottom
/it/docs/CSS/color	/it/docs/Web/CSS/color
/it/docs/CSS/cursor	/it/docs/Web/CSS/cursor
/it/docs/CSS/cursor/Usare_valori_URL_per_la_proprietà_cursor	/it/docs/Web/CSS/cursor/Usare_valori_URL_per_la_propriet%C3%A0_cursor
/it/docs/CSS/text-align	/it/docs/Web/CSS/text-align
/it/docs/CSS/text-shadow	/it/docs/Web/CSS/text-shadow
/it/docs/CSS/transition-timing-function	/it/docs/Web/CSS/transition-timing-function
/it/docs/CSS/vertical-align	/it/docs/Web/CSS/vertical-align
/it/docs/CSS/word-break	/it/docs/Web/CSS/word-break
/it/docs/CSS::-moz-first-node	/docs/it/CSS/:-moz-first-node
/it/docs/CSS::-moz-last-node	/docs/it/CSS/:-moz-last-node
/it/docs/CSS::-moz-list-bullet	/docs/it/CSS/:-moz-list-bullet
/it/docs/CSS:@-moz-document	/docs/it/CSS/@-moz-document
/it/docs/CSS:Getting_Started	/docs/it/CSS/Getting_Started
/it/docs/CSS:background	/docs/it/CSS/background
/it/docs/CSS:background-attachment	/docs/it/CSS/background-attachment
/it/docs/CSS:background-color	/docs/it/CSS/background-color
/it/docs/CSS:background-image	/docs/it/CSS/background-image
/it/docs/CSS:text-align	/docs/it/CSS/text-align
/it/docs/CSS_Reference/Mozilla_Extensions	/it/docs/CSS/Mozilla_Extensions
/it/docs/CSS_Reference:Mozilla_Extensions	/docs/it/CSS_Reference/Mozilla_Extensions
/it/docs/Canvas_tutorial:Basic_usage	/docs/it/Canvas_tutorial/Basic_usage
/it/docs/Canvas_tutorial:Utilizzo_di_base	/docs/it/Canvas_tutorial/Utilizzo_di_base
/it/docs/Compatibilità_di_AJAX	/it/docs/AJAX
/it/docs/Conoscere_i_CSS-redirect-1	/it/docs/Conoscere_i_CSS
/it/docs/Conoscere_i_CSS/Che_cosa_sono_i_CSS-redirect-1	/it/docs/Conoscere_i_CSS/Che_cosa_sono_i_CSS
/it/docs/Conoscere_i_CSS:CSS_leggibili	/docs/it/Conoscere_i_CSS/CSS_leggibili
/it/docs/Conoscere_i_CSS:Cascata_ed_ereditarietà	/docs/it/Conoscere_i_CSS/Cascata_ed_ereditariet%C3%A0
/it/docs/Conoscere_i_CSS:Che_cosa_sono_i_CSS	/docs/it/Conoscere_i_CSS/Che_cosa_sono_i_CSS
/it/docs/Conoscere_i_CSS:Colori	/docs/it/Conoscere_i_CSS/Colori
/it/docs/Conoscere_i_CSS:Come_funzionano_i_CSS	/docs/it/Conoscere_i_CSS/Come_funzionano_i_CSS
/it/docs/Conoscere_i_CSS:I_Selettori	/docs/it/Conoscere_i_CSS/I_Selettori
/it/docs/Conoscere_i_CSS:Perché_usare_i_CSS	/docs/it/Conoscere_i_CSS/Perch%C3%A9_usare_i_CSS
/it/docs/Conoscere_i_CSS:Stili_del_testo	/docs/it/Conoscere_i_CSS/Stili_del_testo
/it/docs/Core_JavaScript_1.5_Reference	/it/docs/Web/JavaScript/Reference
/it/docs/Crea_Documentazione	/docs/it/Documentazione_per_build
/it/docs/DOM/Selection	/it/docs/Web/API/Selection
/it/docs/DOM/Selection/addRange	/it/docs/Web/API/Selection/addRange
/it/docs/DOM/Selection/anchorNode	/it/docs/Web/API/Selection/anchorNode
/it/docs/DOM/Selection/anchorOffset	/it/docs/Web/API/Selection/anchorOffset
/it/docs/DOM/Selection/collapse	/it/docs/Web/API/Selection/collapse
/it/docs/DOM/Selection/collapseToEnd	/it/docs/Web/API/Selection/collapseToEnd
/it/docs/DOM/Selection/collapseToStart	/it/docs/Web/API/Selection/collapseToStart
/it/docs/DOM/Selection/containsNode	/it/docs/Web/API/Selection/containsNode
/it/docs/DOM/Selection/deleteFromDocument	/it/docs/Web/API/Selection/deleteFromDocument
/it/docs/DOM/Selection/extend	/it/docs/Web/API/Selection/extend
/it/docs/DOM/Selection/focusNode	/it/docs/Web/API/Selection/focusNode
/it/docs/DOM/Selection/focusOffset	/it/docs/Web/API/Selection/focusOffset
/it/docs/DOM/Selection/getRangeAt	/it/docs/Web/API/Selection/getRangeAt
/it/docs/DOM/Selection/isCollapsed	/it/docs/Web/API/Selection/isCollapsed
/it/docs/DOM/Selection/rangeCount	/it/docs/Web/API/Selection/rangeCount
/it/docs/DOM/Selection/removeAllRanges	/it/docs/Web/API/Selection/removeAllRanges
/it/docs/DOM/Selection/removeRange	/it/docs/Web/API/Selection/removeRange
/it/docs/DOM/Selection/selectAllChildren	/it/docs/Web/API/Selection/selectAllChildren
/it/docs/DOM/Selection/toString	/it/docs/Web/API/Selection/toString
/it/docs/DOM/XMLHttpRequest	/it/docs/Web/API/XMLHttpRequest
/it/docs/DOM/XMLHttpRequest/Usare_XMLHttpRequest	/it/docs/Web/API/XMLHttpRequest/Usare_XMLHttpRequest
/it/docs/DOM/document	/it/docs/Web/API/Document
/it/docs/DOM/document.URL	/it/docs/Web/API/Document/URL
/it/docs/DOM/document.anchors	/it/docs/Web/API/Document/anchors
/it/docs/DOM/document.applets	/it/docs/Web/API/Document/applets
/it/docs/DOM/document.body	/it/docs/Web/API/Document/body
/it/docs/DOM/document.characterSet	/it/docs/Web/API/Document/characterSet
/it/docs/DOM/document.close	/it/docs/Web/API/Document/close
/it/docs/DOM/document.createElement	/it/docs/Web/API/Document/createElement
/it/docs/DOM/document.createElementNS	/it/docs/Web/API/Document/createElementNS
/it/docs/DOM/document.createRange	/it/docs/Web/API/Document/createRange
/it/docs/DOM/document.defaultView	/it/docs/Web/API/Document/defaultView
/it/docs/DOM/document.doctype	/it/docs/Web/API/Document/doctype
/it/docs/DOM/document.documentElement	/it/docs/Web/API/Document/documentElement
/it/docs/DOM/document.firstChild	/it/docs/Web/API/Document/firstChild
/it/docs/DOM/document.forms	/it/docs/Web/API/Document/forms
/it/docs/DOM/document.getElementById	/it/docs/Web/API/Document/getElementById
/it/docs/DOM/document.getElementsByName	/it/docs/Web/API/Document/getElementsByName
/it/docs/DOM/document.height	/it/docs/Web/API/Document/height
/it/docs/DOM/document.importNode	/it/docs/Web/API/Document/importNode
/it/docs/DOM/document.lastModified	/it/docs/Web/API/Document/lastModified
/it/docs/DOM/document.links	/it/docs/Web/API/Document/links
/it/docs/DOM/document.namespaceURI	/it/docs/Web/API/Document/namespaceURI
/it/docs/DOM/document.open	/it/docs/Web/API/Document/open
/it/docs/DOM/document.referrer	/it/docs/Web/API/Document/referrer
/it/docs/DOM/document.styleSheets	/it/docs/Web/API/Document/styleSheets
/it/docs/DOM/document.title	/it/docs/Web/API/Document/title
/it/docs/DOM/document.width	/it/docs/Web/API/Document/width
/it/docs/DOM/element	/it/docs/Web/API/Element
/it/docs/DOM/element.addEventListener	/it/docs/Web/API/Element/addEventListener
/it/docs/DOM/element.attributes	/it/docs/Web/API/Element/attributes
/it/docs/DOM/element.childNodes	/it/docs/Web/API/Element/childNodes
/it/docs/DOM/element.className	/it/docs/Web/API/Element/className
/it/docs/DOM/element.clientHeight	/it/docs/Web/API/Element/clientHeight
/it/docs/DOM/element.firstChild	/it/docs/Web/API/Element/firstChild
/it/docs/DOM/element.hasAttributes	/it/docs/Web/API/Element/hasAttributes
/it/docs/DOM/element.nodeName	/it/docs/Web/API/Element/nodeName
/it/docs/DOM/element.nodeType	/it/docs/Web/API/Element/nodeType
/it/docs/DOM/element.nodeValue	/it/docs/Web/API/Element/nodeValue
/it/docs/DOM/element.parentNode	/it/docs/Web/API/Element/parentNode
/it/docs/DOM/element.prefix	/it/docs/Web/API/Element/prefix
/it/docs/DOM/element.textContent	/it/docs/Web/API/Element/textContent
/it/docs/DOM/event	/it/docs/Web/API/Event
/it/docs/DOM/event.altKey	/it/docs/Web/API/Event/altKey
/it/docs/DOM/event.bubbles	/it/docs/Web/API/Event/bubbles
/it/docs/DOM/event.button	/it/docs/Web/API/Event/button
/it/docs/DOM/event.cancelable	/it/docs/Web/API/Event/cancelable
/it/docs/DOM/event.charCode	/it/docs/Web/API/Event/charCode
/it/docs/DOM/event.ctrlKey	/it/docs/Web/API/Event/ctrlKey
/it/docs/DOM/event.detail	/it/docs/Web/API/Event/detail
/it/docs/DOM/event.eventPhase	/it/docs/Web/API/Event/eventPhase
/it/docs/DOM/event.isChar	/it/docs/Web/API/Event/isChar
/it/docs/DOM/event.keyCode	/it/docs/Web/API/Event/keyCode
/it/docs/DOM/event.layerX	/it/docs/Web/API/Event/layerX
/it/docs/DOM/event.layerY	/it/docs/Web/API/Event/layerY
/it/docs/DOM/event.metaKey	/it/docs/Web/API/Event/metaKey
/it/docs/DOM/event.pageX	/it/docs/Web/API/Event/pageX
/it/docs/DOM/event.pageY	/it/docs/Web/API/Event/pageY
/it/docs/DOM/event.preventDefault	/it/docs/Web/API/Event/preventDefault
/it/docs/DOM/event.shiftKey	/it/docs/Web/API/Event/shiftKey
/it/docs/DOM/event.stopPropagation	/it/docs/Web/API/Event/stopPropagation
/it/docs/DOM/event.timeStamp	/it/docs/Web/API/Event/timeStamp
/it/docs/DOM/event.type	/it/docs/Web/API/Event/type
/it/docs/DOM/event.view	/it/docs/Web/API/Event/view
/it/docs/DOM/event.which	/it/docs/Web/API/Event/which
/it/docs/DOM/form	/it/docs/Web/API/HTMLFormElement
/it/docs/DOM/form.acceptCharset	/it/docs/Web/API/HTMLFormElement/acceptCharset
/it/docs/DOM/form.action	/it/docs/Web/API/HTMLFormElement/action
/it/docs/DOM/form.elements	/it/docs/Web/API/HTMLFormElement/elements
/it/docs/DOM/form.enctype	/it/docs/Web/API/HTMLFormElement/enctype
/it/docs/DOM/form.length	/it/docs/Web/API/HTMLFormElement/length
/it/docs/DOM/form.method	/it/docs/Web/API/HTMLFormElement/method
/it/docs/DOM/form.name	/it/docs/Web/API/HTMLFormElement/name
/it/docs/DOM/form.reset	/it/docs/Web/API/HTMLFormElement/reset
/it/docs/DOM/form.submit	/it/docs/Web/API/HTMLFormElement/submit
/it/docs/DOM/form.target	/it/docs/Web/API/HTMLFormElement/target
/it/docs/DOM/range	/it/docs/Web/API/Range
/it/docs/DOM/range.cloneContents	/it/docs/Web/API/Range/cloneContents
/it/docs/DOM/range.cloneRange	/it/docs/Web/API/Range/cloneRange
/it/docs/DOM/range.collapse	/it/docs/Web/API/Range/collapse
/it/docs/DOM/range.collapsed	/it/docs/Web/API/Range/collapsed
/it/docs/DOM/range.commonAncestorContainer	/it/docs/Web/API/Range/commonAncestorContainer
/it/docs/DOM/range.compareBoundaryPoints	/it/docs/Web/API/Range/compareBoundaryPoints
/it/docs/DOM/range.comparePoint	/it/docs/Web/API/Range/comparePoint
/it/docs/DOM/range.createContextualFragment	/it/docs/Web/API/Range/createContextualFragment
/it/docs/DOM/range.deleteContents	/it/docs/Web/API/Range/deleteContents
/it/docs/DOM/range.detach	/it/docs/Web/API/Range/detach
/it/docs/DOM/range.endContainer	/it/docs/Web/API/Range/endContainer
/it/docs/DOM/range.endOffset	/it/docs/Web/API/Range/endOffset
/it/docs/DOM/range.extractContents	/it/docs/Web/API/Range/extractContents
/it/docs/DOM/range.insertNode	/it/docs/Web/API/Range/insertNode
/it/docs/DOM/range.isPointInRange	/it/docs/Web/API/Range/isPointInRange
/it/docs/DOM/range.selectNode	/it/docs/Web/API/Range/selectNode
/it/docs/DOM/range.selectNodeContents	/it/docs/Web/API/Range/selectNodeContents
/it/docs/DOM/range.setEnd	/it/docs/Web/API/Range/setEnd
/it/docs/DOM/range.setEndAfter	/it/docs/Web/API/Range/setEndAfter
/it/docs/DOM/range.setEndBefore	/it/docs/Web/API/Range/setEndBefore
/it/docs/DOM/range.setStart	/it/docs/Web/API/Range/setStart
/it/docs/DOM/range.setStartAfter	/it/docs/Web/API/Range/setStartAfter
/it/docs/DOM/range.setStartBefore	/it/docs/Web/API/Range/setStartBefore
/it/docs/DOM/range.startContainer	/it/docs/Web/API/Range/startContainer
/it/docs/DOM/range.startOffset	/it/docs/Web/API/Range/startOffset
/it/docs/DOM/range.surroundContents	/it/docs/Web/API/Range/surroundContents
/it/docs/DOM/range.toString	/it/docs/Web/API/Range/toString
/it/docs/DOM/window	/it/docs/Web/API/Window
/it/docs/DOM/window.alert	/it/docs/Web/API/Window/alert
/it/docs/DOM/window.back	/it/docs/Web/API/Window/back
/it/docs/DOM/window.blur	/it/docs/Web/API/Window/blur
/it/docs/DOM/window.closed	/it/docs/Web/API/Window/closed
/it/docs/DOM/window.confirm	/it/docs/Web/API/Window/confirm
/it/docs/DOM/window.defaultStatus	/it/docs/Web/API/Window/defaultstatus
/it/docs/DOM/window.document	/it/docs/Web/API/Window/document
/it/docs/DOM/window.focus	/it/docs/Web/API/Window/focus
/it/docs/DOM/window.forward	/it/docs/Web/API/Window/forward
/it/docs/DOM/window.getSelection	/it/docs/Web/API/Window/getSelection
/it/docs/DOM/window.history	/it/docs/Web/API/Window/history
/it/docs/DOM/window.home	/it/docs/Web/API/Window/home
/it/docs/DOM/window.locationbar	/it/docs/Web/API/Window/locationbar
/it/docs/DOM/window.moveBy	/it/docs/Web/API/Window/moveBy
/it/docs/DOM/window.moveTo	/it/docs/Web/API/Window/moveTo
/it/docs/DOM/window.name	/it/docs/Web/API/Window/name
/it/docs/DOM/window.opener	/it/docs/Web/API/Window/opener
/it/docs/DOM/window.print	/it/docs/Web/API/Window/print
/it/docs/DOM/window.prompt	/it/docs/Web/API/Window/prompt
/it/docs/DOM/window.resizeBy	/it/docs/Web/API/Window/resizeBy
/it/docs/DOM/window.resizeTo	/it/docs/Web/API/Window/resizeTo
/it/docs/DOM/window.sizeToContent	/it/docs/Web/API/Window/sizeToContent
/it/docs/DOM/window.status	/it/docs/Web/API/Window/status
/it/docs/DOM/window.statusbar	/it/docs/Web/API/Window/statusbar
/it/docs/DOM/window.stop	/it/docs/Web/API/Window/stop
/it/docs/DOM:Selection	/docs/it/DOM/Selection
/it/docs/DOM:Selection:addRange	/docs/it/DOM/Selection/addRange
/it/docs/DOM:Selection:anchorNode	/docs/it/DOM/Selection/anchorNode
/it/docs/DOM:Selection:anchorOffset	/docs/it/DOM/Selection/anchorOffset
/it/docs/DOM:Selection:collapse	/docs/it/DOM/Selection/collapse
/it/docs/DOM:Selection:collapseToEnd	/docs/it/DOM/Selection/collapseToEnd
/it/docs/DOM:Selection:collapseToStart	/docs/it/DOM/Selection/collapseToStart
/it/docs/DOM:Selection:containsNode	/docs/it/DOM/Selection/containsNode
/it/docs/DOM:Selection:deleteFromDocument	/docs/it/DOM/Selection/deleteFromDocument
/it/docs/DOM:Selection:extend	/docs/it/DOM/Selection/extend
/it/docs/DOM:Selection:focusNode	/docs/it/DOM/Selection/focusNode
/it/docs/DOM:Selection:focusOffset	/docs/it/DOM/Selection/focusOffset
/it/docs/DOM:Selection:getRangeAt	/docs/it/DOM/Selection/getRangeAt
/it/docs/DOM:Selection:isCollapsed	/docs/it/DOM/Selection/isCollapsed
/it/docs/DOM:Selection:rangeCount	/docs/it/DOM/Selection/rangeCount
/it/docs/DOM:Selection:removeAllRanges	/docs/it/DOM/Selection/removeAllRanges
/it/docs/DOM:Selection:removeRange	/docs/it/DOM/Selection/removeRange
/it/docs/DOM:Selection:selectAllChildren	/docs/it/DOM/Selection/selectAllChildren
/it/docs/DOM:Selection:toString	/docs/it/DOM/Selection/toString
/it/docs/DOM:document	/docs/it/DOM/document
/it/docs/DOM:document.URL	/docs/it/DOM/document.URL
/it/docs/DOM:document.anchors	/docs/it/DOM/document.anchors
/it/docs/DOM:document.applets	/docs/it/DOM/document.applets
/it/docs/DOM:document.body	/docs/it/DOM/document.body
/it/docs/DOM:document.characterSet	/docs/it/DOM/document.characterSet
/it/docs/DOM:document.close	/docs/it/DOM/document.close
/it/docs/DOM:document.createElement	/docs/it/DOM/document.createElement
/it/docs/DOM:document.createElementNS	/docs/it/DOM/document.createElementNS
/it/docs/DOM:document.createRange	/docs/it/DOM/document.createRange
/it/docs/DOM:document.defaultView	/docs/it/DOM/document.defaultView
/it/docs/DOM:document.doctype	/docs/it/DOM/document.doctype
/it/docs/DOM:document.documentElement	/docs/it/DOM/document.documentElement
/it/docs/DOM:document.firstChild	/docs/it/DOM/document.firstChild
/it/docs/DOM:document.forms	/docs/it/DOM/document.forms
/it/docs/DOM:document.getElementById	/docs/it/DOM/document.getElementById
/it/docs/DOM:document.getElementsByName	/docs/it/DOM/document.getElementsByName
/it/docs/DOM:document.height	/docs/it/DOM/document.height
/it/docs/DOM:document.importNode	/docs/it/DOM/document.importNode
/it/docs/DOM:document.lastModified	/docs/it/DOM/document.lastModified
/it/docs/DOM:document.links	/docs/it/DOM/document.links
/it/docs/DOM:document.namespaceURI	/docs/it/DOM/document.namespaceURI
/it/docs/DOM:document.open	/docs/it/DOM/document.open
/it/docs/DOM:document.referrer	/docs/it/DOM/document.referrer
/it/docs/DOM:document.styleSheets	/docs/it/DOM/document.styleSheets
/it/docs/DOM:document.title	/docs/it/DOM/document.title
/it/docs/DOM:document.width	/docs/it/DOM/document.width
/it/docs/DOM:element	/docs/it/DOM/element
/it/docs/DOM:element.addEventListener	/docs/it/DOM/element.addEventListener
/it/docs/DOM:element.attributes	/docs/it/DOM/element.attributes
/it/docs/DOM:element.childNodes	/docs/it/DOM/element.childNodes
/it/docs/DOM:element.className	/docs/it/DOM/element.className
/it/docs/DOM:element.clientHeight	/docs/it/DOM/element.clientHeight
/it/docs/DOM:element.firstChild	/docs/it/DOM/element.firstChild
/it/docs/DOM:element.hasAttributes	/docs/it/DOM/element.hasAttributes
/it/docs/DOM:element.nodeName	/docs/it/DOM/element.nodeName
/it/docs/DOM:element.nodeType	/docs/it/DOM/element.nodeType
/it/docs/DOM:element.nodeValue	/docs/it/DOM/element.nodeValue
/it/docs/DOM:element.parentNode	/docs/it/DOM/element.parentNode
/it/docs/DOM:element.prefix	/docs/it/DOM/element.prefix
/it/docs/DOM:element.textContent	/docs/it/DOM/element.textContent
/it/docs/DOM:event	/docs/it/DOM/event
/it/docs/DOM:event.altKey	/docs/it/DOM/event.altKey
/it/docs/DOM:event.bubbles	/docs/it/DOM/event.bubbles
/it/docs/DOM:event.button	/docs/it/DOM/event.button
/it/docs/DOM:event.cancelable	/docs/it/DOM/event.cancelable
/it/docs/DOM:event.charCode	/docs/it/DOM/event.charCode
/it/docs/DOM:event.ctrlKey	/docs/it/DOM/event.ctrlKey
/it/docs/DOM:event.detail	/docs/it/DOM/event.detail
/it/docs/DOM:event.eventPhase	/docs/it/DOM/event.eventPhase
/it/docs/DOM:event.isChar	/docs/it/DOM/event.isChar
/it/docs/DOM:event.keyCode	/docs/it/DOM/event.keyCode
/it/docs/DOM:event.layerX	/docs/it/DOM/event.layerX
/it/docs/DOM:event.layerY	/docs/it/DOM/event.layerY
/it/docs/DOM:event.metaKey	/docs/it/DOM/event.metaKey
/it/docs/DOM:event.pageX	/docs/it/DOM/event.pageX
/it/docs/DOM:event.pageY	/docs/it/DOM/event.pageY
/it/docs/DOM:event.preventDefault	/docs/it/DOM/event.preventDefault
/it/docs/DOM:event.shiftKey	/docs/it/DOM/event.shiftKey
/it/docs/DOM:event.stopPropagation	/docs/it/DOM/event.stopPropagation
/it/docs/DOM:event.timeStamp	/docs/it/DOM/event.timeStamp
/it/docs/DOM:event.type	/docs/it/DOM/event.type
/it/docs/DOM:event.view	/docs/it/DOM/event.view
/it/docs/DOM:event.which	/docs/it/DOM/event.which
/it/docs/DOM:form	/docs/it/DOM/form
/it/docs/DOM:form.acceptCharset	/docs/it/DOM/form.acceptCharset
/it/docs/DOM:form.action	/docs/it/DOM/form.action
/it/docs/DOM:form.elements	/docs/it/DOM/form.elements
/it/docs/DOM:form.enctype	/docs/it/DOM/form.enctype
/it/docs/DOM:form.length	/docs/it/DOM/form.length
/it/docs/DOM:form.method	/docs/it/DOM/form.method
/it/docs/DOM:form.name	/docs/it/DOM/form.name
/it/docs/DOM:form.reset	/docs/it/DOM/form.reset
/it/docs/DOM:form.submit	/docs/it/DOM/form.submit
/it/docs/DOM:form.target	/docs/it/DOM/form.target
/it/docs/DOM:range	/docs/it/DOM/range
/it/docs/DOM:range.cloneContents	/docs/it/DOM/range.cloneContents
/it/docs/DOM:range.cloneRange	/docs/it/DOM/range.cloneRange
/it/docs/DOM:range.collapse	/docs/it/DOM/range.collapse
/it/docs/DOM:range.collapsed	/docs/it/DOM/range.collapsed
/it/docs/DOM:range.commonAncestorContainer	/docs/it/DOM/range.commonAncestorContainer
/it/docs/DOM:range.compareBoundaryPoints	/docs/it/DOM/range.compareBoundaryPoints
/it/docs/DOM:range.comparePoint	/docs/it/DOM/range.comparePoint
/it/docs/DOM:range.createContextualFragment	/docs/it/DOM/range.createContextualFragment
/it/docs/DOM:range.deleteContents	/docs/it/DOM/range.deleteContents
/it/docs/DOM:range.detach	/docs/it/DOM/range.detach
/it/docs/DOM:range.endContainer	/docs/it/DOM/range.endContainer
/it/docs/DOM:range.endOffset	/docs/it/DOM/range.endOffset
/it/docs/DOM:range.extractContents	/docs/it/DOM/range.extractContents
/it/docs/DOM:range.insertNode	/docs/it/DOM/range.insertNode
/it/docs/DOM:range.isPointInRange	/docs/it/DOM/range.isPointInRange
/it/docs/DOM:range.selectNode	/docs/it/DOM/range.selectNode
/it/docs/DOM:range.selectNodeContents	/docs/it/DOM/range.selectNodeContents
/it/docs/DOM:range.setEnd	/docs/it/DOM/range.setEnd
/it/docs/DOM:range.setEndAfter	/docs/it/DOM/range.setEndAfter
/it/docs/DOM:range.setEndBefore	/docs/it/DOM/range.setEndBefore
/it/docs/DOM:range.setStart	/docs/it/DOM/range.setStart
/it/docs/DOM:range.setStartAfter	/docs/it/DOM/range.setStartAfter
/it/docs/DOM:range.setStartBefore	/docs/it/DOM/range.setStartBefore
/it/docs/DOM:range.startContainer	/docs/it/DOM/range.startContainer
/it/docs/DOM:range.startOffset	/docs/it/DOM/range.startOffset
/it/docs/DOM:range.surroundContents	/docs/it/DOM/range.surroundContents
/it/docs/DOM:range.toString	/docs/it/DOM/range.toString
/it/docs/DOM:window	/docs/it/DOM/window
/it/docs/DOM:window.alert	/docs/it/DOM/window.alert
/it/docs/DOM:window.back	/docs/it/DOM/window.back
/it/docs/DOM:window.blur	/docs/it/DOM/window.blur
/it/docs/DOM:window.closed	/docs/it/DOM/window.closed
/it/docs/DOM:window.confirm	/docs/it/DOM/window.confirm
/it/docs/DOM:window.defaultStatus	/docs/it/DOM/window.defaultStatus
/it/docs/DOM:window.document	/docs/it/DOM/window.document
/it/docs/DOM:window.focus	/docs/it/DOM/window.focus
/it/docs/DOM:window.forward	/docs/it/DOM/window.forward
/it/docs/DOM:window.getSelection	/docs/it/DOM/window.getSelection
/it/docs/DOM:window.history	/docs/it/DOM/window.history
/it/docs/DOM:window.home	/docs/it/DOM/window.home
/it/docs/DOM:window.locationbar	/docs/it/DOM/window.locationbar
/it/docs/DOM:window.moveBy	/docs/it/DOM/window.moveBy
/it/docs/DOM:window.moveTo	/docs/it/DOM/window.moveTo
/it/docs/DOM:window.name	/docs/it/DOM/window.name
/it/docs/DOM:window.opener	/docs/it/DOM/window.opener
/it/docs/DOM:window.print	/docs/it/DOM/window.print
/it/docs/DOM:window.prompt	/docs/it/DOM/window.prompt
/it/docs/DOM:window.resizeBy	/docs/it/DOM/window.resizeBy
/it/docs/DOM:window.resizeTo	/docs/it/DOM/window.resizeTo
/it/docs/DOM:window.sizeToContent	/docs/it/DOM/window.sizeToContent
/it/docs/DOM:window.status	/docs/it/DOM/window.status
/it/docs/DOM:window.statusbar	/docs/it/DOM/window.statusbar
/it/docs/DOM:window.stop	/docs/it/DOM/window.stop
/it/docs/Developer_Guide	/it/docs/Mozilla/Developer_guide
/it/docs/Documentazione_per_build	/it/docs/Mozilla/Developer_guide/Documentazione_per_build
/it/docs/Estensioni:Comunità	/docs/it/Estensioni/Comunit%C3%A0
/it/docs/Extensions	/docs/it/Estensioni
/it/docs/Firefox_1.5	/it/docs/Firefox_1.5_per_Sviluppatori
/it/docs/Firefox_2	/docs/it/Firefox_2.0_per_Sviluppatori
/it/docs/Firefox_2_per_Sviluppatori	/docs/it/Firefox_2.0_per_Sviluppatori
/it/docs/Firefox_3_for_developers	/docs/It/Firefox_3_per_sviluppatori/Firefox_3_per_sviluppatori
/it/docs/Getting_started_with_XULRunner	/it/docs/Archive/Mozilla/XULRunner/Getting_started_with_XULRunner
/it/docs/Guida_di_riferimento_ai_CSS	/it/docs/Web/CSS/Guida_di_riferimento_ai_CSS
/it/docs/HTML	/it/docs/Web/HTML
/it/docs/HTML/Aree_tematiche	/it/docs/Web/HTML/Aree_tematiche
/it/docs/HTML/Attributi	/it/docs/Web/HTML/Attributi
/it/docs/HTML/Canvas	/it/docs/Web/HTML/Canvas
/it/docs/HTML/Canvas/Drawing_graphics_with_canvas	/it/docs/Web/HTML/Canvas/Drawing_graphics_with_canvas
/it/docs/HTML/Element	/it/docs/Web/HTML/Element
/it/docs/HTML/Element/a	/it/docs/Web/HTML/Element/a
/it/docs/HTML/Element/abbr	/it/docs/Web/HTML/Element/abbr
/it/docs/HTML/Element/address	/it/docs/Web/HTML/Element/address
/it/docs/HTML/Element/area	/it/docs/Web/HTML/Element/area
/it/docs/HTML/Element/article	/it/docs/Web/HTML/Element/article
/it/docs/HTML/Element/html	/it/docs/Web/HTML/Element/html
/it/docs/HTML/Element/output	/it/docs/Web/HTML/Element/output
/it/docs/HTML/Element/section	/it/docs/Web/HTML/Element/section
/it/docs/HTML/Element/time	/it/docs/Web/HTML/Element/time
/it/docs/HTML/Forms_in_HTML	/it/docs/Web/HTML/Forms_in_HTML
/it/docs/HTML/Global_attributes	/it/docs/Web/HTML/Global_attributes
/it/docs/HTML/HTML5	/it/docs/Web/HTML/HTML5
/it/docs/HTML/HTML5/Introduction_to_HTML5	/it/docs/Web/HTML/HTML5/Introduction_to_HTML5
/it/docs/HTML/Introduzione	/it/docs/Learn/HTML/Introduction_to_HTML
/it/docs/HTML/Sections_and_Outlines_of_an_HTML5_document	/it/docs/Web/HTML/Sections_and_Outlines_of_an_HTML5_document
/it/docs/HTML/Using_HTML5_audio_and_video	/it/docs/Web/HTML/Using_HTML5_audio_and_video
/it/docs/HTML/utilizzare_application_cache	/it/docs/Web/HTML/utilizzare_application_cache
/it/docs/Hacking_Firefox	/it/docs/Mozilla/Developer_guide/Introduction
/it/docs/Il_DOM_e_JavaScript	/it/docs/Web/JavaScript/Il_DOM_e_JavaScript
/it/docs/Importare_applicazioni_da_Internet_Explorer_a_Mozilla	/it/docs/Migrare_applicazioni_da_Internet_Explorer_a_Mozilla
/it/docs/Introduzione	/it/docs/Mozilla/Developer_guide/Introduzione
/it/docs/Introduzione_al_carattere_Object-Oriented_di_JavaScript	/it/docs/Web/JavaScript/Introduzione_al_carattere_Object-Oriented_di_JavaScript
/it/docs/JavaScript	/it/docs/Web/JavaScript
/it/docs/JavaScript/ECMAScript_6_support_in_Mozilla	/it/docs/Web/JavaScript/ECMAScript_6_support_in_Mozilla
/it/docs/JavaScript/Guida	/it/docs/Web/JavaScript/Guida
/it/docs/JavaScript/Guide/Predefined_Core_Objects	/it/docs/JavaScript/Guida/Oggetti_nativi
/it/docs/JavaScript/New_in_JavaScript	/it/docs/Web/JavaScript/New_in_JavaScript
/it/docs/JavaScript/New_in_JavaScript/Novità_in_JavaScript_1.6	/it/docs/Web/JavaScript/New_in_JavaScript/Novit%C3%A0_in_JavaScript_1.6
/it/docs/JavaScript/New_in_JavaScript/Novità_in_JavaScript_1.7	/it/docs/Web/JavaScript/New_in_JavaScript/Novit%C3%A0_in_JavaScript_1.7
/it/docs/JavaScript/Reference	/it/docs/Web/JavaScript/Reference
/it/docs/JavaScript/Reference/Functions_and_function_scope	/it/docs/Web/JavaScript/Reference/Functions_and_function_scope
/it/docs/JavaScript/Reference/Global_Objects	/it/docs/Web/JavaScript/Reference/Global_Objects
/it/docs/JavaScript/Reference/Global_Objects/Object	/it/docs/Web/JavaScript/Reference/Global_Objects/Object
/it/docs/JavaScript/Reference/Global_Objects/Object/keys	/it/docs/Web/JavaScript/Reference/Global_Objects/Object/keys
/it/docs/JavaScript/Reference/Global_Objects/eval	/it/docs/Web/JavaScript/Reference/Global_Objects/eval
/it/docs/JavaScript/Reference/Statements	/it/docs/Web/JavaScript/Reference/Statements
/it/docs/JavaScript/Reference/Statements/let	/it/docs/Web/JavaScript/Reference/Statements/let
/it/docs/JavaScript/Una_reintroduzione_al_JavaScript	/it/docs/Web/JavaScript/Una_reintroduzione_al_JavaScript
/it/docs/Learn/CSS/Basics/Box_model	/en-US/docs/Learn/CSS/Building_blocks/The_box_model
/it/docs/Learn/CSS/Introduction_to_CSS	/en-US/docs/Learn/CSS/First_steps
/it/docs/Learn/CSS/Introduction_to_CSS/Come_funziona_CSS	/en-US/docs/Learn/CSS/First_steps/How_CSS_works
/it/docs/Learn/CSS/Styling_boxes	/en-US/docs/Learn/CSS/Building_blocks
/it/docs/Learn/CSS/Styling_boxes/Stili_per_tabelle	/it/docs/Learn/CSS/Building_blocks/Styling_tables
/it/docs/Libertà!_Uguaglianza!_Validità!	/en-US/docs/Learn/HTML/Introduction_to_HTML/Debugging_HTML
/it/docs/Linux_Build_Prerequisites	/it/docs/Mozilla/Developer_guide/Documentazione_per_build/Linux_Build_Prerequisites
/it/docs/Localizing_Firefox_OS	/it/docs/Mozilla/B2G_OS/Developing_Firefox_OS/Localizing_Firefox_OS
/it/docs/Localizzazione	/it/docs/Localization
/it/docs/MDN/Doc_status/Firefox_OS	/it/docs/MDN/Doc_status/B2G_OS
/it/docs/Mozilla/B2G_OS	/it/docs/Archive/B2G_OS
/it/docs/Mozilla/B2G_OS/Apps	/it/docs/Archive/B2G_OS/Apps
/it/docs/Mozilla/B2G_OS/Apps/Writing_a_web_app_for_Firefox_OS	/it/docs/Archive/B2G_OS/Apps/Writing_a_web_app_for_Firefox_OS
/it/docs/Mozilla/B2G_OS/Building	/it/docs/Archive/B2G_OS/Building
/it/docs/Mozilla/B2G_OS/Building_and_installing_Firefox_OS	/it/docs/Archive/B2G_OS/Building_and_installing_Firefox_OS
/it/docs/Mozilla/B2G_OS/Building_and_installing_Firefox_OS/Compatible_Devices	/it/docs/Archive/B2G_OS/Building_and_installing_Firefox_OS/Compatible_Devices
/it/docs/Mozilla/B2G_OS/Building_and_installing_Firefox_OS/Sommario_del_processo_di_compilazione_di_B2G_OS	/it/docs/Archive/B2G_OS/Building_and_installing_Firefox_OS/Sommario_del_processo_di_compilazione_di_B2G_OS
/it/docs/Mozilla/B2G_OS/Debugging	/it/docs/Archive/B2G_OS/Debugging
/it/docs/Mozilla/B2G_OS/Debugging/Installazione_ADB	/it/docs/Archive/B2G_OS/Debugging/Installazione_ADB
/it/docs/Mozilla/B2G_OS/Developer_phone_guide	/it/docs/Archive/B2G_OS/Developer_phone_guide
/it/docs/Mozilla/B2G_OS/Developer_phone_guide/Fairphone	/it/docs/Archive/B2G_OS/Developer_phone_guide/Fairphone
/it/docs/Mozilla/B2G_OS/Developer_phone_guide/Flame	/it/docs/Archive/B2G_OS/Developer_phone_guide/Flame
/it/docs/Mozilla/B2G_OS/Developer_phone_guide/Geeksphone	/it/docs/Archive/B2G_OS/Developer_phone_guide/Geeksphone
/it/docs/Mozilla/B2G_OS/Developer_phone_guide/Specifiche_telefoni_dispositivi	/it/docs/Archive/B2G_OS/Developer_phone_guide/Specifiche_telefoni_dispositivi
/it/docs/Mozilla/B2G_OS/Developer_phone_guide/ZTE_OPEN	/it/docs/Archive/B2G_OS/Developer_phone_guide/ZTE_OPEN
/it/docs/Mozilla/B2G_OS/Developer_phone_guide/ZTE_OPEN_C	/it/docs/Archive/B2G_OS/Developer_phone_guide/ZTE_OPEN_C
/it/docs/Mozilla/B2G_OS/Developing_Firefox_OS	/it/docs/Archive/B2G_OS/Developing_Firefox_OS
/it/docs/Mozilla/B2G_OS/Developing_Firefox_OS/Filing_bugs_against_Firefox_OS	/it/docs/Archive/B2G_OS/Developing_Firefox_OS/Filing_bugs_against_Firefox_OS
/it/docs/Mozilla/B2G_OS/Developing_Firefox_OS/Localizing_Firefox_OS	/it/docs/Archive/B2G_OS/Developing_Firefox_OS/Localizing_Firefox_OS
/it/docs/Mozilla/B2G_OS/Firefox_OS_usage_tips	/it/docs/Archive/B2G_OS/Firefox_OS_usage_tips
/it/docs/Mozilla/B2G_OS/Guida_rapida_allo_sviluppo_di_Gaia	/it/docs/Archive/B2G_OS/Guida_rapida_allo_sviluppo_di_Gaia
/it/docs/Mozilla/B2G_OS/Guida_rapida_allo_sviluppo_di_Gaia/Build_System_Primer	/it/docs/Archive/B2G_OS/Guida_rapida_allo_sviluppo_di_Gaia/Build_System_Primer
/it/docs/Mozilla/B2G_OS/Guida_rapida_allo_sviluppo_di_Gaia/Customizing_build-time_apps	/it/docs/Archive/B2G_OS/Guida_rapida_allo_sviluppo_di_Gaia/Customizing_build-time_apps
/it/docs/Mozilla/B2G_OS/Guida_rapida_allo_sviluppo_di_Gaia/Diversi_modi_per_eseguire_Gaia	/it/docs/Archive/B2G_OS/Guida_rapida_allo_sviluppo_di_Gaia/Diversi_modi_per_eseguire_Gaia
/it/docs/Mozilla/B2G_OS/Guida_rapida_allo_sviluppo_di_Gaia/Gaia_tools_reference	/it/docs/Archive/B2G_OS/Guida_rapida_allo_sviluppo_di_Gaia/Gaia_tools_reference
/it/docs/Mozilla/B2G_OS/Guida_rapida_allo_sviluppo_di_Gaia/Making_Gaia_code_changes	/it/docs/Archive/B2G_OS/Guida_rapida_allo_sviluppo_di_Gaia/Making_Gaia_code_changes
/it/docs/Mozilla/B2G_OS/Guida_rapida_allo_sviluppo_di_Gaia/Running_the_Gaia_codebase	/it/docs/Archive/B2G_OS/Guida_rapida_allo_sviluppo_di_Gaia/Running_the_Gaia_codebase
/it/docs/Mozilla/B2G_OS/Guida_rapida_allo_sviluppo_di_Gaia/Submitting_a_Gaia_patch	/it/docs/Archive/B2G_OS/Guida_rapida_allo_sviluppo_di_Gaia/Submitting_a_Gaia_patch
/it/docs/Mozilla/B2G_OS/Guida_rapida_allo_sviluppo_di_Gaia/Testing_Gaia_code_changes	/it/docs/Archive/B2G_OS/Guida_rapida_allo_sviluppo_di_Gaia/Testing_Gaia_code_changes
/it/docs/Mozilla/B2G_OS/Guida_rapida_allo_sviluppo_di_Gaia/Understanding_the_Gaia_codebase	/it/docs/Archive/B2G_OS/Guida_rapida_allo_sviluppo_di_Gaia/Understanding_the_Gaia_codebase
/it/docs/Mozilla/B2G_OS/Guida_rapida_allo_sviluppo_di_Gaia/make_options_reference	/it/docs/Archive/B2G_OS/Guida_rapida_allo_sviluppo_di_Gaia/make_options_reference
/it/docs/Mozilla/B2G_OS/Installare_su_un_dispositivo_mobile	/it/docs/Archive/B2G_OS/Installare_su_un_dispositivo_mobile
/it/docs/Mozilla/B2G_OS/Introduction	/it/docs/Archive/B2G_OS/Introduction
/it/docs/Mozilla/B2G_OS/Platform	/it/docs/Archive/B2G_OS/Platform
/it/docs/Mozilla/B2G_OS/Platform/Apps_architecture	/it/docs/Archive/B2G_OS/Platform/Apps_architecture
/it/docs/Mozilla/B2G_OS/Platform/Architecture	/it/docs/Archive/B2G_OS/Platform/Architecture
/it/docs/Mozilla/B2G_OS/Platform/Automated_testing	/it/docs/Archive/B2G_OS/Platform/Automated_testing
/it/docs/Mozilla/B2G_OS/Platform/Feature_support_chart	/it/docs/Archive/B2G_OS/Platform/Feature_support_chart
/it/docs/Mozilla/B2G_OS/Platform/Gaia	/it/docs/Archive/B2G_OS/Platform/Gaia
/it/docs/Mozilla/B2G_OS/Platform/Gaia/Gaia_apps	/it/docs/Archive/B2G_OS/Platform/Gaia/Gaia_apps
/it/docs/Mozilla/B2G_OS/Platform/Gaia/Hacking	/it/docs/Archive/B2G_OS/Platform/Gaia/Hacking
/it/docs/Mozilla/B2G_OS/Platform/Gonk	/it/docs/Archive/B2G_OS/Platform/Gonk
/it/docs/Mozilla/B2G_OS/Platform/Settings_list	/it/docs/Archive/B2G_OS/Platform/Settings_list
/it/docs/Mozilla/B2G_OS/Preparazione_della_tua_prima_build_di_B2G	/it/docs/Archive/B2G_OS/Preparazione_della_tua_prima_build_di_B2G
/it/docs/Mozilla/B2G_OS/Prerequisiti_Firefox_OS_build	/it/docs/Archive/B2G_OS/Prerequisiti_Firefox_OS_build
/it/docs/Mozilla/B2G_OS/Security	/it/docs/Archive/B2G_OS/Security
/it/docs/Mozilla/B2G_OS/Security/Security_model	/it/docs/Archive/B2G_OS/Security/Security_model
/it/docs/Mozilla/B2G_OS/Sviluppo_applicazioni	/it/docs/Archive/B2G_OS/Sviluppo_applicazioni
/it/docs/Mozilla/B2G_OS/TVs_connected_devices	/it/docs/Archive/B2G_OS/TVs_connected_devices
/it/docs/Mozilla/B2G_OS/UX	/it/docs/Archive/B2G_OS/UX
/it/docs/Mozilla/B2G_OS/UX/Building_blocks	/it/docs/Archive/B2G_OS/UX/Building_blocks
/it/docs/Mozilla/B2G_OS/UX/Building_blocks/Action_menu	/it/docs/Archive/B2G_OS/UX/Building_blocks/Action_menu
/it/docs/Mozilla/B2G_OS/UX/Building_blocks/Bottoni	/it/docs/Archive/B2G_OS/UX/Building_blocks/Bottoni
/it/docs/Mozilla/B2G_OS/UX/Building_blocks/Conferme	/it/docs/Archive/B2G_OS/UX/Building_blocks/Conferme
/it/docs/Mozilla/B2G_OS/UX/Design_asset_library	/it/docs/Archive/B2G_OS/UX/Design_asset_library
/it/docs/Mozilla/B2G_OS/Web_applications	/it/docs/Archive/B2G_OS/Web_applications
/it/docs/Mozilla/B2G_OS/usare_l_app_Manager	/it/docs/Archive/B2G_OS/usare_l_app_Manager
/it/docs/Mozilla/Developer_Program	/it/docs/Mozilla/Connettere
/it/docs/Mozilla/Developer_guide/Introduzione	/it/docs/Mozilla/Developer_guide/Introduction
/it/docs/Mozilla/Firefox_OS	/it/docs/Mozilla/B2G_OS
/it/docs/Mozilla/Firefox_OS/Apps	/it/docs/Mozilla/B2G_OS/Apps
/it/docs/Mozilla/Firefox_OS/Apps/Writing_a_web_app_for_Firefox_OS	/it/docs/Mozilla/B2G_OS/Apps/Writing_a_web_app_for_Firefox_OS
/it/docs/Mozilla/Firefox_OS/Building	/it/docs/Mozilla/B2G_OS/Building
/it/docs/Mozilla/Firefox_OS/Building_and_installing_Firefox_OS	/it/docs/Mozilla/B2G_OS/Building_and_installing_Firefox_OS
/it/docs/Mozilla/Firefox_OS/Building_and_installing_Firefox_OS/Compatible_Devices	/it/docs/Mozilla/B2G_OS/Building_and_installing_Firefox_OS/Compatible_Devices
/it/docs/Mozilla/Firefox_OS/Debugging	/it/docs/Mozilla/B2G_OS/Debugging
/it/docs/Mozilla/Firefox_OS/Debugging/Installazione_ADB	/it/docs/Mozilla/B2G_OS/Debugging/Installazione_ADB
/it/docs/Mozilla/Firefox_OS/Developer_phone_guide	/it/docs/Mozilla/B2G_OS/Developer_phone_guide
/it/docs/Mozilla/Firefox_OS/Developer_phone_guide/Fairphone	/it/docs/Mozilla/B2G_OS/Developer_phone_guide/Fairphone
/it/docs/Mozilla/Firefox_OS/Developer_phone_guide/Flame	/it/docs/Mozilla/B2G_OS/Developer_phone_guide/Flame
/it/docs/Mozilla/Firefox_OS/Developer_phone_guide/Geeksphone	/it/docs/Mozilla/B2G_OS/Developer_phone_guide/Geeksphone
/it/docs/Mozilla/Firefox_OS/Developer_phone_guide/Specifiche_telefoni_dispositivi	/it/docs/Mozilla/B2G_OS/Developer_phone_guide/Specifiche_telefoni_dispositivi
/it/docs/Mozilla/Firefox_OS/Developer_phone_guide/ZTE_OPEN	/it/docs/Mozilla/B2G_OS/Developer_phone_guide/ZTE_OPEN
/it/docs/Mozilla/Firefox_OS/Developer_phone_guide/ZTE_OPEN_C	/it/docs/Mozilla/B2G_OS/Developer_phone_guide/ZTE_OPEN_C
/it/docs/Mozilla/Firefox_OS/Developing_Firefox_OS	/it/docs/Mozilla/B2G_OS/Developing_Firefox_OS
/it/docs/Mozilla/Firefox_OS/Developing_Firefox_OS/Filing_bugs_against_Firefox_OS	/it/docs/Mozilla/B2G_OS/Developing_Firefox_OS/Filing_bugs_against_Firefox_OS
/it/docs/Mozilla/Firefox_OS/Firefox_OS_usage_tips	/it/docs/Mozilla/B2G_OS/Firefox_OS_usage_tips
/it/docs/Mozilla/Firefox_OS/Firefox_OS_usage_tips/debug_remoto	/it/docs/Mozilla/B2G_OS/Firefox_OS_usage_tips/debug_remoto
/it/docs/Mozilla/Firefox_OS/Guida_rapida_allo_sviluppo_di_Gaia	/it/docs/Mozilla/B2G_OS/Guida_rapida_allo_sviluppo_di_Gaia
/it/docs/Mozilla/Firefox_OS/Guida_rapida_allo_sviluppo_di_Gaia/Build_System_Primer	/it/docs/Mozilla/B2G_OS/Guida_rapida_allo_sviluppo_di_Gaia/Build_System_Primer
/it/docs/Mozilla/Firefox_OS/Guida_rapida_allo_sviluppo_di_Gaia/Customizing_build-time_apps	/it/docs/Mozilla/B2G_OS/Guida_rapida_allo_sviluppo_di_Gaia/Customizing_build-time_apps
/it/docs/Mozilla/Firefox_OS/Guida_rapida_allo_sviluppo_di_Gaia/Diversi_modi_per_eseguire_Gaia	/it/docs/Mozilla/B2G_OS/Guida_rapida_allo_sviluppo_di_Gaia/Diversi_modi_per_eseguire_Gaia
/it/docs/Mozilla/Firefox_OS/Guida_rapida_allo_sviluppo_di_Gaia/Gaia_tools_reference	/it/docs/Mozilla/B2G_OS/Guida_rapida_allo_sviluppo_di_Gaia/Gaia_tools_reference
/it/docs/Mozilla/Firefox_OS/Guida_rapida_allo_sviluppo_di_Gaia/Making_Gaia_code_changes	/it/docs/Mozilla/B2G_OS/Guida_rapida_allo_sviluppo_di_Gaia/Making_Gaia_code_changes
/it/docs/Mozilla/Firefox_OS/Guida_rapida_allo_sviluppo_di_Gaia/Running_the_Gaia_codebase	/it/docs/Mozilla/B2G_OS/Guida_rapida_allo_sviluppo_di_Gaia/Running_the_Gaia_codebase
/it/docs/Mozilla/Firefox_OS/Guida_rapida_allo_sviluppo_di_Gaia/Submitting_a_Gaia_patch	/it/docs/Mozilla/B2G_OS/Guida_rapida_allo_sviluppo_di_Gaia/Submitting_a_Gaia_patch
/it/docs/Mozilla/Firefox_OS/Guida_rapida_allo_sviluppo_di_Gaia/Testing_Gaia_code_changes	/it/docs/Mozilla/B2G_OS/Guida_rapida_allo_sviluppo_di_Gaia/Testing_Gaia_code_changes
/it/docs/Mozilla/Firefox_OS/Guida_rapida_allo_sviluppo_di_Gaia/Understanding_the_Gaia_codebase	/it/docs/Mozilla/B2G_OS/Guida_rapida_allo_sviluppo_di_Gaia/Understanding_the_Gaia_codebase
/it/docs/Mozilla/Firefox_OS/Guida_rapida_allo_sviluppo_di_Gaia/make_options_reference	/it/docs/Mozilla/B2G_OS/Guida_rapida_allo_sviluppo_di_Gaia/make_options_reference
/it/docs/Mozilla/Firefox_OS/Installare_su_un_dispositivo_mobile	/it/docs/Mozilla/B2G_OS/Installare_su_un_dispositivo_mobile
/it/docs/Mozilla/Firefox_OS/Introduction	/it/docs/Mozilla/B2G_OS/Introduction
/it/docs/Mozilla/Firefox_OS/Platform	/it/docs/Mozilla/B2G_OS/Platform
/it/docs/Mozilla/Firefox_OS/Platform/Apps_architecture	/it/docs/Mozilla/B2G_OS/Platform/Apps_architecture
/it/docs/Mozilla/Firefox_OS/Platform/Architecture	/it/docs/Mozilla/B2G_OS/Platform/Architecture
/it/docs/Mozilla/Firefox_OS/Platform/Automated_testing	/it/docs/Mozilla/B2G_OS/Platform/Automated_testing
/it/docs/Mozilla/Firefox_OS/Platform/Feature_support_chart	/it/docs/Mozilla/B2G_OS/Platform/Feature_support_chart
/it/docs/Mozilla/Firefox_OS/Platform/Gaia	/it/docs/Mozilla/B2G_OS/Platform/Gaia
/it/docs/Mozilla/Firefox_OS/Platform/Gaia/Gaia_apps	/it/docs/Mozilla/B2G_OS/Platform/Gaia/Gaia_apps
/it/docs/Mozilla/Firefox_OS/Platform/Gaia/Hacking	/it/docs/Mozilla/B2G_OS/Platform/Gaia/Hacking
/it/docs/Mozilla/Firefox_OS/Platform/Gonk	/it/docs/Mozilla/B2G_OS/Platform/Gonk
/it/docs/Mozilla/Firefox_OS/Platform/Settings_list	/it/docs/Mozilla/B2G_OS/Platform/Settings_list
/it/docs/Mozilla/Firefox_OS/Preparazione_della_tua_prima_build_di_B2G	/it/docs/Mozilla/B2G_OS/Preparazione_della_tua_prima_build_di_B2G
/it/docs/Mozilla/Firefox_OS/Prerequisiti_Firefox_OS_build	/it/docs/Mozilla/B2G_OS/Prerequisiti_Firefox_OS_build
/it/docs/Mozilla/Firefox_OS/Security	/it/docs/Mozilla/B2G_OS/Security
/it/docs/Mozilla/Firefox_OS/Security/Security_model	/it/docs/Mozilla/B2G_OS/Security/Security_model
/it/docs/Mozilla/Firefox_OS/Sviluppo_applicazioni	/it/docs/Mozilla/B2G_OS/Sviluppo_applicazioni
/it/docs/Mozilla/Firefox_OS/TVs_connected_devices	/it/docs/Mozilla/B2G_OS/TVs_connected_devices
/it/docs/Mozilla/Firefox_OS/UX	/it/docs/Mozilla/B2G_OS/UX
/it/docs/Mozilla/Firefox_OS/UX/Building_blocks	/it/docs/Mozilla/B2G_OS/UX/Building_blocks
/it/docs/Mozilla/Firefox_OS/UX/Building_blocks/Action_menu	/it/docs/Mozilla/B2G_OS/UX/Building_blocks/Action_menu
/it/docs/Mozilla/Firefox_OS/UX/Building_blocks/Bottoni	/it/docs/Mozilla/B2G_OS/UX/Building_blocks/Bottoni
/it/docs/Mozilla/Firefox_OS/UX/Building_blocks/Conferme	/it/docs/Mozilla/B2G_OS/UX/Building_blocks/Conferme
/it/docs/Mozilla/Firefox_OS/UX/Design_asset_library	/it/docs/Mozilla/B2G_OS/UX/Design_asset_library
/it/docs/Mozilla/Firefox_OS/usare_l_app_Manager	/it/docs/Mozilla/B2G_OS/usare_l_app_Manager
/it/docs/Mozilla/Marketplace/Monetization	/en-US/Marketplace/Monetization/Introduction_Monetization
/it/docs/Mozilla/Marketplace/Prepare	/en-US/Marketplace/Prepare/Introduction
/it/docs/Mozilla/Persona/The_implementor_s_guide	/it/docs/Archive/Mozilla/Persona/The_implementor_s_guide
/it/docs/Mozilla/Persona/The_implementor_s_guide/Testing	/it/docs/Archive/Mozilla/Persona/The_implementor_s_guide/Testing
/it/docs/Mozilla/Tech/XUL	/it/docs/Archive/Mozilla/XUL
/it/docs/Mozilla/Tech/XUL/Tutorial	/it/docs/Archive/Mozilla/XUL/Tutorial
/it/docs/Note_di_rilascio_di_XULRunner_1.8.0.4	/it/docs/Archive/Mozilla/XULRunner/Note_di_rilascio_di_XULRunner_1.8.0.4
/it/docs/Note_di_rilascio_di_XULRunner_1.8.0.4_Release_Notes	/it/docs/Note_di_rilascio_di_XULRunner_1.8.0.4
/it/docs/Novità_in_JavaScript_1.6	/it/docs/JavaScript/New_in_JavaScript/Novit%C3%A0_in_JavaScript_1.6
/it/docs/Novità_in_JavaScript_1.7	/it/docs/JavaScript/New_in_JavaScript/Novit%C3%A0_in_JavaScript_1.7
/it/docs/Pagina_Principale	/docs/it
/it/docs/Persona	/it/docs/Archive/Mozilla/Persona
/it/docs/Persona/.well-known-browserid	/it/docs/Archive/Mozilla/Persona/.well-known-browserid
/it/docs/Persona/Compatibilità_con_i_Browser	/it/docs/Archive/Mozilla/Persona/Compatibilit%C3%A0_con_i_Browser
/it/docs/Persona/Internationalization	/it/docs/Archive/Mozilla/Persona/Internationalization
/it/docs/Persona/Libraries_and_plugins	/it/docs/Archive/Mozilla/Persona/Libraries_and_plugins
/it/docs/Persona/Quick_Setup	/it/docs/Archive/Mozilla/Persona/Quick_Setup
/it/docs/Persona/Remote_Verification_API	/it/docs/Archive/Mozilla/Persona/Remote_Verification_API
/it/docs/Persona/Security_Considerations	/it/docs/Archive/Mozilla/Persona/Security_Considerations
/it/docs/Persona/The_navigator.id_API	/it/docs/Archive/Mozilla/Persona/The_navigator.id_API
/it/docs/Persona/Why_Persona	/it/docs/Archive/Mozilla/Persona/Why_Persona
/it/docs/Plugins	/docs/it/Plug-in
/it/docs/Problemi_Derivanti_Dall_Hover_Su_Elementi_Arbitrari	/it/docs/Archive/Standard_Web/Issues_Arising_From_Arbitrary-Element_hover
/it/docs/Project:How_to_Help-redirect-1	/it/docs/Project:How_to_Help
/it/docs/Project:en/Project:Getting_started-redirect-1	/it/docs/Project:en/Project:Getting_started
/it/docs/Project:en/Project:MDC_editor_guide	/it/docs/MDN/Contribute/Editor/Basics
/it/docs/RDF_in_cinquanta_parole_o_meno	/it/docs/Archive/Standard_Web/RDF_in_Fifty_Words_or_Less
/it/docs/RSS	/it/docs/Archive/RSS
/it/docs/RSS/Iniziare	/it/docs/Archive/RSS/Iniziare
/it/docs/RSS:Iniziare	/docs/it/RSS/Iniziare
/it/docs/Reference_del_DOM_di_Gecko:Esempi	/docs/it/Reference_del_DOM_di_Gecko/Esempi
/it/docs/Reference_del_DOM_di_Gecko:Introduzione	/docs/it/Reference_del_DOM_di_Gecko/Introduzione
/it/docs/Rich-Text_Editing_in_Mozilla	/it/docs/Web/Guide/HTML/Editable_content/Rich-Text_Editing_in_Mozilla
/it/docs/Scripting_Plugins:_Macromedia_Flash	/docs/it/Scripting_Plugins/Macromedia_Flash
/it/docs/Security	/en-US/docs/Web/Security
/it/docs/Standard_Web	/it/docs/Archive/Standard_Web
/it/docs/Strumenti:Validare	/docs/it/Strumenti/Validare
/it/docs/Strumenti:Validatori	/docs/it/Strumenti/Validatori
/it/docs/Supportare_i_suggerimenti_nei_plugin_di_ricerca	/it/docs/Archive/Add-ons/Supportare_i_suggerimenti_nei_plugin_di_ricerca
/it/docs/Sviluppare_un'Estensione	/it/docs/Archive/Add-ons/Sviluppare_un_Estensione
/it/docs/Tinderbox	/it/docs/Archive/Mozilla/Tinderbox
/it/docs/Tools/Firefox_OS_Simulator	/it/docs/Archive/B2G_OS/Simulator
/it/docs/Una_re-introduzione_a_Javascript	/it/docs/JavaScript/Una_reintroduzione_al_JavaScript
/it/docs/Usare_le_URL_nella_proprietà_cursor	/it/docs/Usare_valori_URL_per_la_propriet%C3%A0_cursor
/it/docs/Usare_valori_URL_per_la_proprietà_cursor	/it/docs/CSS/cursor/Usare_valori_URL_per_la_propriet%C3%A0_cursor
/it/docs/Web/API/Element.getElementsByTagName	/it/docs/Web/API/Element/getElementsByTagName
/it/docs/Web/API/Element.scrollHeight	/it/docs/Web/API/Element/scrollHeight
/it/docs/Web/API/Navigator.cookieEnabled	/it/docs/Web/API/Navigator/cookieEnabled
/it/docs/Web/API/Position	/it/docs/Web/API/GeolocationPosition
/it/docs/Web/API/URLUtils.href	/it/docs/Web/API/URLUtils/href
/it/docs/Web/API/document.write()	/it/docs/Web/API/Document/write
/it/docs/Web/Apps/Quickstart/Build	/it/docs/Archive/B2G_OS/Quickstart
/it/docs/Web/Apps/Quickstart/Build/App_tools	/it/docs/Archive/B2G_OS/Quickstart/App_tools
/it/docs/Web/Apps/Quickstart/Build/Intro_app_web_aperte	/it/docs/Archive/B2G_OS/Quickstart/Intro_app_web_aperte
/it/docs/Web/Apps/Quickstart/Build/Intro_to_Firefox_OS	/it/docs/Archive/B2G_OS/Quickstart/Intro_to_Firefox_OS
/it/docs/Web/Apps/Quickstart/Build/La_tua_prima_app	/it/docs/Archive/B2G_OS/Quickstart/La_tua_prima_app
/it/docs/Web/Apps/Quickstart/Build/per_sviluppatori_web	/it/docs/Archive/B2G_OS/Quickstart/per_sviluppatori_web
/it/docs/Web/CSS/@-moz-document	/it/docs/Web/CSS/%40document
/it/docs/Web/CSS/Getting_Started	/it/docs/Conoscere_i_CSS
/it/docs/Web/Events/devicemotion	/it/docs/Web/API/Window/devicemotion_event
/it/docs/Web/Events/orientationchange	/it/docs/Web/API/Window/orientationchange_event
/it/docs/Web/Guide/HTML	/it/docs/Learn/HTML
/it/docs/Web/HTML/Aree_tematiche	/it/docs/Web/Guide/HTML/Categorie_di_contenuto
/it/docs/Web/JavaScript/Guide	/it/docs/JavaScript/Guida
/it/docs/Web/JavaScript/Guide/About	/it/docs/JavaScript/Guida/About
/it/docs/Web/JavaScript/Guide/Expressions_and_Operators	/it/docs/JavaScript/Guida/Expressions_and_Operators
/it/docs/Web/JavaScript/Reference/Operators/Spread_operator	/docs/Web/JavaScript/Reference/Operators/Spread_syntax
/it/docs/Web/WebGL	/it/docs/Web/API/WebGL_API
/it/docs/XBL	/it/docs/Archive/Mozilla/XBL
/it/docs/XMLHttpRequest	/it/docs/DOM/XMLHttpRequest
/it/docs/XPCOM:Binding_per_i_linguaggi	/docs/it/XPCOM/Binding_per_i_linguaggi
/it/docs/XPInstall	/docs/it/XPI
/it/docs/XPath	/it/docs/Web/XPath
/it/docs/XSLT	/it/docs/Web/XSLT
/it/docs/XUL	/it/docs/Mozilla/Tech/XUL
/it/docs/XUL/Tutorial	/it/docs/Mozilla/Tech/XUL/Tutorial
/it/docs/XULRunner	/it/docs/Archive/Mozilla/XULRunner
/it/docs/XULRunner/A_cosa_serve_XULRunner	/it/docs/Archive/Mozilla/XULRunner/A_cosa_serve_XULRunner
/it/docs/XULRunner:A_cosa_serve_XULRunner	/docs/it/XULRunner/A_cosa_serve_XULRunner
/it/docs/XULRunner_FAQ	/it/docs/Archive/Mozilla/XULRunner/XULRunner_FAQ
/it/docs/en	/
/it/docs/persona/marchio	/it/docs/Archive/Mozilla/Persona/marchio
