# FROM-URL	TO-URL
/pt-BR/docs/AJAX	/pt-BR/docs/Web/Guide/AJAX
/pt-BR/docs/AJAX/Getting_Started	/pt-BR/docs/Web/Guide/AJAX/Getting_Started
/pt-BR/docs/API_Web_Audio	/pt-BR/docs/Web/API/API_Web_Audio
/pt-BR/docs/Aplicativos	/pt-BR/docs/Apps
/pt-BR/docs/Apps/Arquitetura de aplicativos	/pt-BR/docs/Apps/Apps_architecture
/pt-BR/docs/Apps/Desenvolvimento_jogos	/pt-BR/docs/Apps/Desenvolvendo_jogos
/pt-BR/docs/Apps/Plataforma-detalhes-específicos	/pt-BR/docs/Apps/Platform-specific_details
/pt-BR/docs/Apps/Tutorials/General/Configurando_seu_ambiente_de_desenvolvimento	/pt-BR/docs/Apps/Tutorials/General/Configuring_your_development_environment
/pt-BR/docs/Apps/Tutorials/Tutorial de desenvolvimento de aplicativos gerais(Stéffano Heckler)	/pt-BR/docs/Apps/Tutorials/General
/pt-BR/docs/Apps/Tópicos_avançados	/pt-BR/docs/Archive/Apps/Advanced_topics
/pt-BR/docs/Apps/Utilizando_aplicativos_offline	/pt-BR/docs/Apps/Using_apps_offline
/pt-BR/docs/Apps/disponibilizando_um_aplicativo	/pt-BR/docs/Apps/Submitting_an_app
/pt-BR/docs/Aprender/CSS/Introduction_to_CSS	/en-US/docs/Learn/CSS/First_steps
/pt-BR/docs/Aprender/CSS/Introduction_to_CSS/Cascade_and_inheritance	/en-US/docs/Learn/CSS/Building_blocks/Cascade_and_inheritance
/pt-BR/docs/Aprender/CSS/Introduction_to_CSS/Combinators_and_multiple_selectors	/en-US/docs/Learn/CSS/Building_blocks/Selectors/Combinators
/pt-BR/docs/Aprender/CSS/Introduction_to_CSS/Seletores	/en-US/docs/Learn/CSS/Building_blocks/Selectors
/pt-BR/docs/Aprender/CSS/Introduction_to_CSS/Valores_e_unidades	/en-US/docs/Learn/CSS/Building_blocks/Values_and_units
/pt-BR/docs/Aprender/CSS/Introduction_to_CSS/como_CSS_funciona	/en-US/docs/Learn/CSS/First_steps/How_CSS_works
/pt-BR/docs/Aprender/CSS/Introduction_to_CSS/sintaxe	/en-US/docs/Learn/CSS/First_steps/How_CSS_is_structured
/pt-BR/docs/Aprender/CSS/Styling_boxes	/en-US/docs/Learn/CSS/Building_blocks
/pt-BR/docs/Aprender/Design_e_acessibilidade	/pt-BR/docs/Learn/Common_questions
/pt-BR/docs/Archive/B2G_OS/Desenvolvendo_no_Firefox_OS	/pt-BR/docs/Archive/B2G_OS/Developing_Firefox_OS
/pt-BR/docs/Archive/B2G_OS/Desenvolvendo_no_Firefox_OS/Customizando_script_b2g.sh	/pt-BR/docs/Archive/B2G_OS/Developing_Firefox_OS/Customizando_script_b2g.sh
/pt-BR/docs/Archive/B2G_OS/Desenvolvendo_no_Firefox_OS/Firefox_OS_bugwork	/pt-BR/docs/Archive/B2G_OS/Developing_Firefox_OS/Firefox_OS_bugwork
/pt-BR/docs/Archive/B2G_OS/Desenvolvendo_no_Firefox_OS/Guia_customizacao_imagem_Firefox_OS	/pt-BR/docs/Archive/B2G_OS/Developing_Firefox_OS/Guia_customizacao_imagem_Firefox_OS
/pt-BR/docs/Archive/B2G_OS/Desenvolvendo_no_Firefox_OS/Guia_rapido_desenvolvimento_Gaia	/pt-BR/docs/Archive/B2G_OS/Developing_Firefox_OS/Guia_rapido_desenvolvimento_Gaia
/pt-BR/docs/Archive/B2G_OS/Desenvolvendo_no_Firefox_OS/Localizando_Firefox_OS	/pt-BR/docs/Archive/B2G_OS/Developing_Firefox_OS/Localizando_Firefox_OS
/pt-BR/docs/Archive/B2G_OS/Desenvolvendo_no_Firefox_OS/Personalizando_teclado_aplicativos_FirefoxOS	/pt-BR/docs/Archive/B2G_OS/Developing_Firefox_OS/Personalizando_teclado_aplicativos_FirefoxOS
/pt-BR/docs/Archive/B2G_OS/Desenvolvendo_no_Firefox_OS/Quickstart_guide_to_B2G_development	/pt-BR/docs/Archive/B2G_OS/Developing_Firefox_OS/Quickstart_guide_to_B2G_development
/pt-BR/docs/Archive/B2G_OS/Developing_Firefox_OS/Especificacoes_Telefones	/pt-BR/docs/Archive/B2G_OS/Phone_guide/Especificacoes_Telefones
/pt-BR/docs/Archive/B2G_OS/Developing_Firefox_OS/Fairphone	/pt-BR/docs/Archive/B2G_OS/Phone_guide/Fairphone
/pt-BR/docs/Archive/B2G_OS/Developing_Firefox_OS/Flame	/pt-BR/docs/Archive/B2G_OS/Phone_guide/Flame
/pt-BR/docs/Archive/B2G_OS/Developing_Firefox_OS/Geeksphone	/pt-BR/docs/Archive/B2G_OS/Phone_guide/Geeksphone
/pt-BR/docs/Archive/B2G_OS/Developing_Firefox_OS/Geeksphone/Perguntas_Frequentes_Geeksphone	/pt-BR/docs/Archive/B2G_OS/Phone_guide/Geeksphone/Perguntas_Frequentes_Geeksphone
/pt-BR/docs/Archive/B2G_OS/Developing_Firefox_OS/Melhores_praticas_dispositivos_referencia_aberta	/pt-BR/docs/Archive/B2G_OS/Phone_guide/Melhores_praticas_dispositivos_referencia_aberta
/pt-BR/docs/Archive/B2G_OS/Developing_Firefox_OS/Recursos_dispositivos_Firefox_OS	/pt-BR/docs/Archive/B2G_OS/Phone_guide/Recursos_dispositivos_Firefox_OS
/pt-BR/docs/Archive/B2G_OS/Developing_Firefox_OS/ZTE_OPEN	/pt-BR/docs/Archive/B2G_OS/Phone_guide/ZTE_OPEN
/pt-BR/docs/Archive/B2G_OS/Developing_Firefox_OS/ZTE_OPEN_C	/pt-BR/docs/Archive/B2G_OS/Phone_guide/ZTE_OPEN_C
/pt-BR/docs/Archive/B2G_OS/Introdução	/pt-BR/docs/Archive/B2G_OS/Introduction
/pt-BR/docs/Archive/B2G_OS/Platform/Automated_testing	/pt-BR/docs/Archive/B2G_OS/Automated_testing
/pt-BR/docs/Archive/B2G_OS/Platform/Automated_testing/Configurando_Marionette	/pt-BR/docs/Archive/B2G_OS/Automated_testing/Configurando_Marionette
/pt-BR/docs/Archive/B2G_OS/Platform/Automated_testing/Gaia_unit_tests	/pt-BR/docs/Archive/B2G_OS/Automated_testing/Gaia_unit_tests
/pt-BR/docs/Archive/B2G_OS/Platform/Automated_testing/Mochitests	/pt-BR/docs/Archive/B2G_OS/Automated_testing/Mochitests
/pt-BR/docs/Archive/B2G_OS/Platform/Automated_testing/gaia-ui-tests	/pt-BR/docs/Archive/B2G_OS/Automated_testing/gaia-ui-tests
/pt-BR/docs/Archive/B2G_OS/Platform/Automated_testing/gaia-ui-tests/Parte_1_Iniciando_Marionette_Firefox_OS	/pt-BR/docs/Archive/B2G_OS/Automated_testing/gaia-ui-tests/Parte_1_Iniciando_Marionette_Firefox_OS
/pt-BR/docs/Archive/B2G_OS/Platform/Automated_testing/gaia-ui-tests/Testes_IU_Gaia_Executando_Testes	/pt-BR/docs/Archive/B2G_OS/Automated_testing/gaia-ui-tests/Testes_IU_Gaia_Executando_Testes
/pt-BR/docs/Archive/B2G_OS/Usande_emuladores_Firefox_OS	/pt-BR/docs/Archive/B2G_OS/Using_the_B2G_emulators
/pt-BR/docs/BrowserID	/en-US/docs/Persona
/pt-BR/docs/CSS	/pt-BR/docs/Web/CSS
/pt-BR/docs/CSS/@page	/pt-BR/docs/Web/CSS/@page
/pt-BR/docs/CSS/At-rule	/pt-BR/docs/Web/CSS/At-rule
/pt-BR/docs/CSS/CSS3	/pt-BR/docs/Web/CSS/CSS3
/pt-BR/docs/CSS/CSS_Reference	/pt-BR/docs/Web/CSS/CSS_Reference
/pt-BR/docs/CSS/Escrever_folhas_de_estilo_eficientes	/pt-BR/docs/Web/CSS/Escrever_folhas_de_estilo_eficientes
/pt-BR/docs/CSS/Especificação	/pt-BR/docs/CSS/Specificity
/pt-BR/docs/CSS/Getting_Started	/pt-BR/docs/Web/CSS/Getting_Started
/pt-BR/docs/CSS/Getting_Started/JavaScript	/pt-BR/docs/Web/CSS/Getting_Started/JavaScript
/pt-BR/docs/CSS/Getting_Started/Oque_&eacute;_CSS	/pt-BR/docs/Web/CSS/Getting_Started/Oque_é_CSS
/pt-BR/docs/CSS/Multiple_backgrounds	/pt-BR/docs/Web/CSS/CSS_Background_and_Borders/Using_CSS_multiple_backgrounds
/pt-BR/docs/CSS/Primeiros_Passos	/pt-BR/docs/CSS/Getting_Started
/pt-BR/docs/CSS/Specificity	/pt-BR/docs/Web/CSS/Specificity
/pt-BR/docs/CSS/Usando_animacoes_CSS	/pt-BR/docs/CSS/Using_CSS_animations
/pt-BR/docs/CSS/Using_CSS_animations	/pt-BR/docs/Web/CSS/CSS_Animations/Usando_anima%C3%A7%C3%B5es_CSS
/pt-BR/docs/CSS/Using_CSS_gradients	/pt-BR/docs/Web/CSS/Using_CSS_gradients
/pt-BR/docs/CSS/Using_CSS_transforms	/pt-BR/docs/Web/CSS/CSS_Transforms/Using_CSS_transforms
/pt-BR/docs/CSS/Writing_Efficient_CSS	/pt-BR/docs/CSS/Escrever_folhas_de_estilo_eficientes
/pt-BR/docs/CSS/display	/pt-BR/docs/Web/CSS/display
/pt-BR/docs/CSS/overflow	/pt-BR/docs/Web/CSS/overflow
/pt-BR/docs/CSS/page-break-after	/pt-BR/docs/Web/CSS/page-break-after
/pt-BR/docs/CSS/regra at	/pt-BR/docs/CSS/At-rule
/pt-BR/docs/CSS/repeating-linear-gradient	/pt-BR/docs/Web/CSS/repeating-linear-gradient
/pt-BR/docs/CSS/sintaxe	/pt-BR/docs/Web/CSS/sintaxe
/pt-BR/docs/CSS/text-overflow	/pt-BR/docs/Web/CSS/text-overflow
/pt-BR/docs/CSS/text-rendering	/pt-BR/docs/Web/CSS/text-rendering
/pt-BR/docs/CSS/transform	/pt-BR/docs/Web/CSS/transform
/pt-BR/docs/CSS/word-wrap	/pt-BR/docs/Web/CSS/word-wrap
/pt-BR/docs/Canvas_tutorial/Basic_usage-redirect-1	/pt-BR/docs/Canvas_tutorial/Basic_usage
/pt-BR/docs/Chrome_Registration	/pt-BR/docs/Mozilla/Chrome_Registration
/pt-BR/docs/Como_construir_um_componente_XPCOM_em_Javascript	/pt-BR/docs/Mozilla/Tech/XPCOM/Como_construir_um_componente_XPCOM_em_Javascript
/pt-BR/docs/Compilacao_Simples_do_Firefox	/pt-BR/docs/Mozilla/Developer_guide/Intrucoes_Build/Compilacao_Simples_do_Firefox
/pt-BR/docs/Compilacao_Simples_do_Firefox/Linux_and_MacOS_build_preparation	/pt-BR/docs/Mozilla/Developer_guide/Intrucoes_Build/Compilacao_Simples_do_Firefox/Linux_and_MacOS_build_preparation
/pt-BR/docs/DOM/BatteryManager.charging	/pt-BR/docs/Web/API/BatteryManager.charging
/pt-BR/docs/DOM/Document.querySelector	/pt-BR/docs/Web/API/Document.querySelector
/pt-BR/docs/DOM/Document.querySelectorAll	/pt-BR/docs/Web/API/Document.querySelectorAll
/pt-BR/docs/DOM/XMLHttpRequest	/pt-BR/docs/Web/API/XMLHttpRequest
/pt-BR/docs/DOM/XMLHttpRequest/Usando_XMLHttpRequest	/pt-BR/docs/Web/API/XMLHttpRequest/Usando_XMLHttpRequest
/pt-BR/docs/DOM/element.addEventListener	/pt-BR/docs/Web/API/Element.addEventListener
/pt-BR/docs/DOM/element.addEventListener-redirect-1	/pt-BR/docs/DOM/element.addEventListener
/pt-BR/docs/DOM/window.URL.createObjectURL	/pt-BR/docs/Web/API/URL.createObjectURL
/pt-BR/docs/DOM/window.onscroll	/pt-BR/docs/Web/API/Window.onscroll
/pt-BR/docs/Developer_Guide	/pt-BR/docs/Mozilla/Developer_guide
/pt-BR/docs/Developer_Guide/Codigo_Fonte	/pt-BR/docs/Mozilla/Developer_guide/Codigo_Fonte
/pt-BR/docs/Developer_Guide/Codigo_Fonte/Downloading_Source_Archives	/pt-BR/docs/Mozilla/Developer_guide/Codigo_Fonte/Downloading_Source_Archives
/pt-BR/docs/Developer_Guide/Intrucoes_Build	/pt-BR/docs/Mozilla/Developer_guide/Intrucoes_Build
/pt-BR/docs/Developer_Guide/Intrucoes_Build/Manifestos_JAR	/pt-BR/docs/Mozilla/Developer_guide/Intrucoes_Build/Manifestos_JAR
/pt-BR/docs/Developer_Guide/Intrucoes_Build/Pre_requisitos_Linux	/pt-BR/docs/Mozilla/Developer_guide/Intrucoes_Build/Pre_requisitos_Linux
/pt-BR/docs/Developer_Guide/Intrucoes_Build/TOC	/pt-BR/docs/Mozilla/Developer_guide/Intrucoes_Build/TOC
/pt-BR/docs/Developer_Guide/Intrucoes_Build/configurando_opcoes_desenvolvimento	/pt-BR/docs/Mozilla/Developer_guide/Intrucoes_Build/configurando_opcoes_desenvolvimento
/pt-BR/docs/Developer_Guide/Mozilla_build_FAQ	/pt-BR/docs/Mozilla/Developer_guide/Mozilla_build_FAQ
/pt-BR/docs/DragDrop/Arrastar_e_Soltar	/pt-BR/docs/DragDrop/Drag_and_Drop
/pt-BR/docs/Eventos_on-line_off-line	/pt-BR/docs/Online_and_offline_events
/pt-BR/docs/Guia_do_Desenvolvedor	/pt-BR/docs/Developer_Guide
/pt-BR/docs/HTML	/pt-BR/docs/Web/HTML
/pt-BR/docs/HTML/Canvas	/pt-BR/docs/Web/HTML/Canvas
/pt-BR/docs/HTML/Dicas_para_criar_páginas_HTML_de_carregamento_rápido	/pt-BR/docs/Web/HTML/Dicas_para_criar_p%C3%A1ginas_HTML_de_carregamento_r%C3%A1pido
/pt-BR/docs/HTML/Element	/pt-BR/docs/Web/HTML/Element
/pt-BR/docs/HTML/Element-redirect-1	/pt-BR/docs/HTML/Element
/pt-BR/docs/HTML/Element/Audio	/pt-BR/docs/Web/HTML/Element/Audio
/pt-BR/docs/HTML/Element/Input	/pt-BR/docs/Web/HTML/Element/Input
/pt-BR/docs/HTML/Element/Output	/pt-BR/docs/Web/HTML/Element/Output
/pt-BR/docs/HTML/Element/Source	/pt-BR/docs/Web/HTML/Element/Source
/pt-BR/docs/HTML/Element/Video	/pt-BR/docs/Web/HTML/Element/Video
/pt-BR/docs/HTML/Element/a	/pt-BR/docs/Web/HTML/Element/a
/pt-BR/docs/HTML/Element/abbr	/pt-BR/docs/Web/HTML/Element/abbr
/pt-BR/docs/HTML/Element/acronym	/pt-BR/docs/Web/HTML/Element/acronym
/pt-BR/docs/HTML/Element/address	/pt-BR/docs/Web/HTML/Element/address
/pt-BR/docs/HTML/Element/area	/pt-BR/docs/Web/HTML/Element/area
/pt-BR/docs/HTML/Element/article	/pt-BR/docs/Web/HTML/Element/article
/pt-BR/docs/HTML/Element/aside	/pt-BR/docs/Web/HTML/Element/aside
/pt-BR/docs/HTML/Element/canvas	/pt-BR/docs/Web/HTML/Element/canvas
/pt-BR/docs/HTML/Element/command	/pt-BR/docs/Web/HTML/Element/command
/pt-BR/docs/HTML/Element/data	/pt-BR/docs/Web/HTML/Element/data
/pt-BR/docs/HTML/Element/datalist	/pt-BR/docs/Web/HTML/Element/datalist
/pt-BR/docs/HTML/Element/details	/pt-BR/docs/Web/HTML/Element/details
/pt-BR/docs/HTML/Element/dfn	/pt-BR/docs/Web/HTML/Element/dfn
/pt-BR/docs/HTML/Element/dl	/pt-BR/docs/Web/HTML/Element/dl
/pt-BR/docs/HTML/Element/figura	/pt-BR/docs/Web/HTML/Element/figura
/pt-BR/docs/HTML/Element/footer	/pt-BR/docs/Web/HTML/Element/footer
/pt-BR/docs/HTML/Element/footer-redirect-1	/pt-BR/docs/HTML/Element/footer
/pt-BR/docs/HTML/Element/form	/pt-BR/docs/Web/HTML/Element/form
/pt-BR/docs/HTML/Element/header	/pt-BR/docs/Web/HTML/Element/header
/pt-BR/docs/HTML/Element/html	/pt-BR/docs/Web/HTML/Element/html
/pt-BR/docs/HTML/Element/ins	/pt-BR/docs/Web/HTML/Element/ins
/pt-BR/docs/HTML/Element/map	/pt-BR/docs/Web/HTML/Element/map
/pt-BR/docs/HTML/Element/mark	/pt-BR/docs/Web/HTML/Element/mark
/pt-BR/docs/HTML/Element/meter	/pt-BR/docs/Web/HTML/Element/meter
/pt-BR/docs/HTML/Element/nav	/pt-BR/docs/Web/HTML/Element/nav
/pt-BR/docs/HTML/Element/optgroup	/pt-BR/docs/Web/HTML/Element/optgroup
/pt-BR/docs/HTML/Element/progress	/pt-BR/docs/Web/HTML/Element/progress
/pt-BR/docs/HTML/Element/rt	/pt-BR/docs/Web/HTML/Element/rt
/pt-BR/docs/HTML/Element/ruby	/pt-BR/docs/Web/HTML/Element/ruby
/pt-BR/docs/HTML/Element/section	/pt-BR/docs/Web/HTML/Element/section
/pt-BR/docs/HTML/Element/span	/pt-BR/docs/Web/HTML/Element/span
/pt-BR/docs/HTML/Element/summary	/pt-BR/docs/Web/HTML/Element/summary
/pt-BR/docs/HTML/Element/table	/pt-BR/docs/Web/HTML/Element/table
/pt-BR/docs/HTML/Element/wbr	/pt-BR/docs/Web/HTML/Element/wbr
/pt-BR/docs/HTML/Elementos HTML	/pt-BR/docs/HTML/Element
/pt-BR/docs/HTML/Formularios_em_HTML	/pt-BR/docs/HTML/Forms_in_HTML
/pt-BR/docs/HTML/HTML5	/pt-BR/docs/Web/HTML/HTML5
/pt-BR/docs/HTML/HTML5/HTML5_element_list	/pt-BR/docs/Web/HTML/HTML5/HTML5_element_list
/pt-BR/docs/HTML/HTML5/Introduction_to_HTML5	/pt-BR/docs/Web/HTML/HTML5/Introduction_to_HTML5
/pt-BR/docs/HTML/HTML5/Introdução_ao_HTML5	/pt-BR/docs/HTML/HTML5/Introduction_to_HTML5
/pt-BR/docs/HTML/HTML_Elements	/pt-BR/docs/Web/HTML/Element
/pt-BR/docs/HTML/HTML_Elements/time	/pt-BR/docs/Web/HTML/Element/time
/pt-BR/docs/HTML/Introducao	/pt-BR/docs/HTML/Introduction
/pt-BR/docs/HTML/Introduction	/pt-BR/docs/Aprender/HTML/Introducao_ao_HTML
/pt-BR/docs/HTML/Optimizing_Your_Pages_for_Speculative_Parsing	/pt-BR/docs/Web/HTML/Optimizing_your_pages_for_speculative_parsing
/pt-BR/docs/HTML/Using_the_application_cache	/pt-BR/docs/Web/HTML/Using_the_application_cache
/pt-BR/docs/Introducao	/pt-BR/docs/Mozilla/Developer_guide/Introducao
/pt-BR/docs/JavaScript	/pt-BR/docs/Web/JavaScript
/pt-BR/docs/JavaScript/A_re-introduction_to_JavaScript	/pt-BR/docs/Web/JavaScript/A_re-introduction_to_JavaScript
/pt-BR/docs/JavaScript/About_JavaScript	/pt-BR/docs/Web/JavaScript/About_JavaScript
/pt-BR/docs/JavaScript/Data_structures	/pt-BR/docs/Web/JavaScript/Data_structures
/pt-BR/docs/JavaScript/Guide	/pt-BR/docs/Web/JavaScript/Guide
/pt-BR/docs/JavaScript/Guide/About	/pt-BR/docs/Web/JavaScript/Guide/About
/pt-BR/docs/JavaScript/Guide/Closures	/pt-BR/docs/Web/JavaScript/Guide/Closures
/pt-BR/docs/JavaScript/Guide/Detalhes_do_Modelo_do_Objeto	/pt-BR/docs/Web/JavaScript/Guide/Detalhes_do_Modelo_do_Objeto
/pt-BR/docs/JavaScript/Guide/Expressions_and_Operators	/pt-BR/docs/Web/JavaScript/Guide/Expressions_and_Operators
/pt-BR/docs/JavaScript/Guide/Herança_Revisitada	/pt-BR/docs/JavaScript/Guide/Inheritance_Revisited
/pt-BR/docs/JavaScript/Guide/Igualdade	/pt-BR/docs/Web/JavaScript/Guide/Igualdade
/pt-BR/docs/JavaScript/Guide/Inheritance_Revisited	/pt-BR/docs/Web/JavaScript/Guide/Inheritance_Revisited
/pt-BR/docs/JavaScript/Guide/JavaScript_Visão_Geral	/pt-BR/docs/Web/JavaScript/Guide/JavaScript_Vis%C3%A3o_Geral
/pt-BR/docs/JavaScript/Guide/Regular_Expressions	/pt-BR/docs/Web/JavaScript/Guide/Regular_Expressions
/pt-BR/docs/JavaScript/Guide/Trabalhando_com_Objetos	/pt-BR/docs/Web/JavaScript/Guide/Trabalhando_com_Objetos
/pt-BR/docs/JavaScript/Guide/Valores,_variáveis_e_literais	/pt-BR/docs/JavaScript/Guide/Values,_variables,_and_literals
/pt-BR/docs/JavaScript/Guide/Values,_variables,_and_literals	/pt-BR/docs/Web/JavaScript/Guide/Values,_variables,_and_literals
/pt-BR/docs/JavaScript/Introduction_to_Object-Oriented_JavaScript	/pt-BR/docs/Web/JavaScript/Introduction_to_Object-Oriented_JavaScript
/pt-BR/docs/JavaScript/JavaScript_technologies_overview	/pt-BR/docs/Web/JavaScript/JavaScript_technologies_overview
/pt-BR/docs/JavaScript/Outras_ferramentas_JavaScript	/pt-BR/docs/Web/JavaScript/Outras_ferramentas_JavaScript
/pt-BR/docs/JavaScript/Reference	/pt-BR/docs/Web/JavaScript/Reference
/pt-BR/docs/JavaScript/Reference/About	/pt-BR/docs/Web/JavaScript/Reference/About
/pt-BR/docs/JavaScript/Reference/Global_Objects	/pt-BR/docs/Web/JavaScript/Reference/Global_Objects
/pt-BR/docs/JavaScript/Reference/Global_Objects/Array	/pt-BR/docs/Web/JavaScript/Reference/Global_Objects/Array
/pt-BR/docs/JavaScript/Reference/Global_Objects/Array/concat	/pt-BR/docs/Web/JavaScript/Reference/Global_Objects/Array/concat
/pt-BR/docs/JavaScript/Reference/Global_Objects/Array/forEach	/pt-BR/docs/Web/JavaScript/Reference/Global_Objects/Array/forEach
/pt-BR/docs/JavaScript/Reference/Global_Objects/Array/splice	/pt-BR/docs/Web/JavaScript/Reference/Global_Objects/Array/splice
/pt-BR/docs/JavaScript/Reference/Global_Objects/Date	/pt-BR/docs/Web/JavaScript/Reference/Global_Objects/Date
/pt-BR/docs/JavaScript/Reference/Global_Objects/Math	/pt-BR/docs/Web/JavaScript/Reference/Global_Objects/Math
/pt-BR/docs/JavaScript/Reference/Global_Objects/Math/exp	/pt-BR/docs/Web/JavaScript/Reference/Global_Objects/Math/exp
/pt-BR/docs/JavaScript/Reference/Global_Objects/Math/floor	/pt-BR/docs/Web/JavaScript/Reference/Global_Objects/Math/floor
/pt-BR/docs/JavaScript/Reference/Global_Objects/Math/sqrt	/pt-BR/docs/Web/JavaScript/Reference/Global_Objects/Math/sqrt
/pt-BR/docs/JavaScript/Reference/Global_Objects/Object	/pt-BR/docs/Web/JavaScript/Reference/Global_Objects/Object
/pt-BR/docs/JavaScript/Reference/Global_Objects/Object/hasOwnProperty	/pt-BR/docs/Web/JavaScript/Reference/Global_Objects/Object/hasOwnProperty
/pt-BR/docs/JavaScript/Reference/Global_Objects/Objetos	/pt-BR/docs/JavaScript/Reference/Global_Objects/Object
/pt-BR/docs/JavaScript/Reference/Global_Objects/Objetos/hasOwnProperty	/pt-BR/docs/JavaScript/Reference/Global_Objects/Object/hasOwnProperty
/pt-BR/docs/JavaScript/Reference/Global_Objects/String	/pt-BR/docs/Web/JavaScript/Reference/Global_Objects/String
/pt-BR/docs/JavaScript/Reference/Global_Objects/String/indexOf	/pt-BR/docs/Web/JavaScript/Reference/Global_Objects/String/indexOf
/pt-BR/docs/JavaScript/Reference/Global_Objects/WeakMap	/pt-BR/docs/Web/JavaScript/Reference/Global_Objects/WeakMap
/pt-BR/docs/JavaScript/Reference/Global_Objects/WeakMap/prototype	/pt-BR/docs/Web/JavaScript/Reference/Global_Objects/WeakMap/prototype
/pt-BR/docs/JavaScript/Reference/Global_Objects/isNaN	/pt-BR/docs/Web/JavaScript/Reference/Global_Objects/isNaN
/pt-BR/docs/JavaScript/Reference/Global_Objects/parseInt	/pt-BR/docs/Web/JavaScript/Reference/Global_Objects/parseInt
/pt-BR/docs/JavaScript/Reference/Operators	/pt-BR/docs/Web/JavaScript/Reference/Operators
/pt-BR/docs/JavaScript/Reference/Operators/Operador_Virgula	/pt-BR/docs/Web/JavaScript/Reference/Operators/Operador_Virgula
/pt-BR/docs/JavaScript/Reference/Operators/typeof	/pt-BR/docs/Web/JavaScript/Reference/Operators/typeof
/pt-BR/docs/JavaScript/Reference/Statements	/pt-BR/docs/Web/JavaScript/Reference/Statements
/pt-BR/docs/JavaScript/Reference/Statements/label	/pt-BR/docs/Web/JavaScript/Reference/Statements/label
/pt-BR/docs/JavaScript/Reference/Statements/let	/pt-BR/docs/Web/JavaScript/Reference/Statements/let
/pt-BR/docs/JavaScript/uma_reintroduction_ao_JavaScript	/pt-BR/docs/JavaScript/A_re-introduction_to_JavaScript
/pt-BR/docs/MDN/Doc_status/Firefox_OS	/pt-BR/docs/MDN/Doc_status/B2G_OS
/pt-BR/docs/MDN/guia_usuário	/pt-BR/docs/MDN/Contribute/Tools
/pt-BR/docs/Mozilla/B2G_OS	/pt-BR/docs/Archive/B2G_OS
/pt-BR/docs/Mozilla/B2G_OS/Add-ons	/pt-BR/docs/Archive/B2G_OS/Add-ons
/pt-BR/docs/Mozilla/B2G_OS/Application_development	/pt-BR/docs/Archive/B2G_OS/Application_development
/pt-BR/docs/Mozilla/B2G_OS/Apps	/pt-BR/docs/Archive/B2G_OS/Apps
/pt-BR/docs/Mozilla/B2G_OS/Apps/Writing_a_web_app_for_Firefox_OS	/pt-BR/docs/Archive/B2G_OS/Apps/Writing_a_web_app_for_Firefox_OS
/pt-BR/docs/Mozilla/B2G_OS/Atualizando_telefone_desenvolvimento	/pt-BR/docs/Archive/B2G_OS/Atualizando_telefone_desenvolvimento
/pt-BR/docs/Mozilla/B2G_OS/Comecando_a_contribuir_para_o_Firefox_OS	/pt-BR/docs/Archive/B2G_OS/Comecando_a_contribuir_para_o_Firefox_OS
/pt-BR/docs/Mozilla/B2G_OS/Compilando_B2G_Emulador_QEMU	/pt-BR/docs/Archive/B2G_OS/Compilando_B2G_Emulador_QEMU
/pt-BR/docs/Mozilla/B2G_OS/Compilando_O_Firefox_OS	/pt-BR/docs/Archive/B2G_OS/Compilando_O_Firefox_OS
/pt-BR/docs/Mozilla/B2G_OS/Compilando_instalando_Firefox_OS	/pt-BR/docs/Archive/B2G_OS/Compilando_instalando_Firefox_OS
/pt-BR/docs/Mozilla/B2G_OS/Construindo_e_instalando_o_Firefox_OS	/pt-BR/docs/Archive/B2G_OS/Construindo_e_instalando_o_Firefox_OS
/pt-BR/docs/Mozilla/B2G_OS/Construindo_e_instalando_o_Firefox_OS/Compilando_o_Firefox_OS_para_o_Flame_no_OSX	/pt-BR/docs/Archive/B2G_OS/Construindo_e_instalando_o_Firefox_OS/Compilando_o_Firefox_OS_para_o_Flame_no_OSX
/pt-BR/docs/Mozilla/B2G_OS/Construindo_e_instalando_o_Firefox_OS/Criando_e_aplicando_pacotes_de_atualizacao_Firefox_OS	/pt-BR/docs/Archive/B2G_OS/Construindo_e_instalando_o_Firefox_OS/Criando_e_aplicando_pacotes_de_atualizacao_Firefox_OS
/pt-BR/docs/Mozilla/B2G_OS/Construindo_e_instalando_o_Firefox_OS/visao_geral_compilacao_firefox_os	/pt-BR/docs/Archive/B2G_OS/Construindo_e_instalando_o_Firefox_OS/visao_geral_compilacao_firefox_os
/pt-BR/docs/Mozilla/B2G_OS/Correções	/pt-BR/docs/Archive/B2G_OS/Corre%C3%A7%C3%B5es
/pt-BR/docs/Mozilla/B2G_OS/Customizacao_com_o_arquivo_.userconfig_file	/pt-BR/docs/Archive/B2G_OS/Customizacao_com_o_arquivo_.userconfig_file
/pt-BR/docs/Mozilla/B2G_OS/Debugging	/pt-BR/docs/Archive/B2G_OS/Debugging
/pt-BR/docs/Mozilla/B2G_OS/Debugging/Conectando_um_dispositivo_com_Firefox_OS_no_desktop	/pt-BR/docs/Archive/B2G_OS/Debugging/Conectando_um_dispositivo_com_Firefox_OS_no_desktop
/pt-BR/docs/Mozilla/B2G_OS/Debugging/Configurando	/pt-BR/docs/Archive/B2G_OS/Debugging/Configurando
/pt-BR/docs/Mozilla/B2G_OS/Debugging/Configurações_do_Desenvolvedor	/pt-BR/docs/Archive/B2G_OS/Debugging/Configura%C3%A7%C3%B5es_do_Desenvolvedor
/pt-BR/docs/Mozilla/B2G_OS/Debugging/Debugging_B2G_using_valgrind	/pt-BR/docs/Archive/B2G_OS/Debugging/Debugging_B2G_using_valgrind
/pt-BR/docs/Mozilla/B2G_OS/Debugging/Depurando_B2G_usando_gdb	/pt-BR/docs/Archive/B2G_OS/Debugging/Depurando_B2G_usando_gdb
/pt-BR/docs/Mozilla/B2G_OS/Debugging/Depurando_erros_falta_de_memoria	/pt-BR/docs/Archive/B2G_OS/Debugging/Depurando_erros_falta_de_memoria
/pt-BR/docs/Mozilla/B2G_OS/Debugging/Firefox_OS_crash_reporting	/pt-BR/docs/Archive/B2G_OS/Debugging/Firefox_OS_crash_reporting
/pt-BR/docs/Mozilla/B2G_OS/Debugging/Instalando_ADB	/pt-BR/docs/Archive/B2G_OS/Debugging/Instalando_ADB
/pt-BR/docs/Mozilla/B2G_OS/Debugging/Intercepting_traffic_using_a_proxy	/pt-BR/docs/Archive/B2G_OS/Debugging/Intercepting_traffic_using_a_proxy
/pt-BR/docs/Mozilla/B2G_OS/Debugging/Log_console_no_dispositivo	/pt-BR/docs/Archive/B2G_OS/Debugging/Log_console_no_dispositivo
/pt-BR/docs/Mozilla/B2G_OS/Debugging/Taking_screenshots	/pt-BR/docs/Archive/B2G_OS/Debugging/Taking_screenshots
/pt-BR/docs/Mozilla/B2G_OS/Desenvolvendo_Gaia	/pt-BR/docs/Archive/B2G_OS/Desenvolvendo_Gaia
/pt-BR/docs/Mozilla/B2G_OS/Desenvolvendo_Gaia/Alterando_aplicativos_empacotados_compilacao_imagem	/pt-BR/docs/Archive/B2G_OS/Desenvolvendo_Gaia/Alterando_aplicativos_empacotados_compilacao_imagem
/pt-BR/docs/Mozilla/B2G_OS/Desenvolvendo_Gaia/Diferente_formas_executar_Gaia	/pt-BR/docs/Archive/B2G_OS/Desenvolvendo_Gaia/Diferente_formas_executar_Gaia
/pt-BR/docs/Mozilla/B2G_OS/Desenvolvendo_Gaia/Entendendo_codebase_gaia	/pt-BR/docs/Archive/B2G_OS/Desenvolvendo_Gaia/Entendendo_codebase_gaia
/pt-BR/docs/Mozilla/B2G_OS/Desenvolvendo_Gaia/Executando_codebase_Gaia	/pt-BR/docs/Archive/B2G_OS/Desenvolvendo_Gaia/Executando_codebase_Gaia
/pt-BR/docs/Mozilla/B2G_OS/Desenvolvendo_Gaia/Fazendo_alteracoes_codigo_Gaia	/pt-BR/docs/Archive/B2G_OS/Desenvolvendo_Gaia/Fazendo_alteracoes_codigo_Gaia
/pt-BR/docs/Mozilla/B2G_OS/Desenvolvendo_Gaia/Ferramentas_Gaia	/pt-BR/docs/Archive/B2G_OS/Desenvolvendo_Gaia/Ferramentas_Gaia
/pt-BR/docs/Mozilla/B2G_OS/Desenvolvendo_Gaia/Submetendo_correcao_Gaia	/pt-BR/docs/Archive/B2G_OS/Desenvolvendo_Gaia/Submetendo_correcao_Gaia
/pt-BR/docs/Mozilla/B2G_OS/Desenvolvendo_Gaia/Testando_alteracoes_gaia	/pt-BR/docs/Archive/B2G_OS/Desenvolvendo_Gaia/Testando_alteracoes_gaia
/pt-BR/docs/Mozilla/B2G_OS/Desenvolvendo_Gaia/melhores_praticas_localizacao_gaia	/pt-BR/docs/Archive/B2G_OS/Desenvolvendo_Gaia/melhores_praticas_localizacao_gaia
/pt-BR/docs/Mozilla/B2G_OS/Desenvolvendo_Gaia/referencia_opcoes_make	/pt-BR/docs/Archive/B2G_OS/Desenvolvendo_Gaia/referencia_opcoes_make
/pt-BR/docs/Mozilla/B2G_OS/Desenvolvendo_no_Firefox_OS	/pt-BR/docs/Archive/B2G_OS/Desenvolvendo_no_Firefox_OS
/pt-BR/docs/Mozilla/B2G_OS/Desenvolvendo_no_Firefox_OS/Customizando_script_b2g.sh	/pt-BR/docs/Archive/B2G_OS/Desenvolvendo_no_Firefox_OS/Customizando_script_b2g.sh
/pt-BR/docs/Mozilla/B2G_OS/Desenvolvendo_no_Firefox_OS/Firefox_OS_bugwork	/pt-BR/docs/Archive/B2G_OS/Desenvolvendo_no_Firefox_OS/Firefox_OS_bugwork
/pt-BR/docs/Mozilla/B2G_OS/Desenvolvendo_no_Firefox_OS/Guia_customizacao_imagem_Firefox_OS	/pt-BR/docs/Archive/B2G_OS/Desenvolvendo_no_Firefox_OS/Guia_customizacao_imagem_Firefox_OS
/pt-BR/docs/Mozilla/B2G_OS/Desenvolvendo_no_Firefox_OS/Guia_rapido_desenvolvimento_Gaia	/pt-BR/docs/Archive/B2G_OS/Desenvolvendo_no_Firefox_OS/Guia_rapido_desenvolvimento_Gaia
/pt-BR/docs/Mozilla/B2G_OS/Desenvolvendo_no_Firefox_OS/Localizando_Firefox_OS	/pt-BR/docs/Archive/B2G_OS/Desenvolvendo_no_Firefox_OS/Localizando_Firefox_OS
/pt-BR/docs/Mozilla/B2G_OS/Desenvolvendo_no_Firefox_OS/Personalizando_teclado_aplicativos_FirefoxOS	/pt-BR/docs/Archive/B2G_OS/Desenvolvendo_no_Firefox_OS/Personalizando_teclado_aplicativos_FirefoxOS
/pt-BR/docs/Mozilla/B2G_OS/Desenvolvendo_no_Firefox_OS/Quickstart_guide_to_B2G_development	/pt-BR/docs/Archive/B2G_OS/Desenvolvendo_no_Firefox_OS/Quickstart_guide_to_B2G_development
/pt-BR/docs/Mozilla/B2G_OS/Developing_Firefox_OS	/pt-BR/docs/Archive/B2G_OS/Developing_Firefox_OS
/pt-BR/docs/Mozilla/B2G_OS/Developing_Firefox_OS/Especificacoes_Telefones	/pt-BR/docs/Archive/B2G_OS/Developing_Firefox_OS/Especificacoes_Telefones
/pt-BR/docs/Mozilla/B2G_OS/Developing_Firefox_OS/Fairphone	/pt-BR/docs/Archive/B2G_OS/Developing_Firefox_OS/Fairphone
/pt-BR/docs/Mozilla/B2G_OS/Developing_Firefox_OS/Flame	/pt-BR/docs/Archive/B2G_OS/Developing_Firefox_OS/Flame
/pt-BR/docs/Mozilla/B2G_OS/Developing_Firefox_OS/Geeksphone	/pt-BR/docs/Archive/B2G_OS/Developing_Firefox_OS/Geeksphone
/pt-BR/docs/Mozilla/B2G_OS/Developing_Firefox_OS/Geeksphone/Perguntas_Frequentes_Geeksphone	/pt-BR/docs/Archive/B2G_OS/Developing_Firefox_OS/Geeksphone/Perguntas_Frequentes_Geeksphone
/pt-BR/docs/Mozilla/B2G_OS/Developing_Firefox_OS/Melhores_praticas_dispositivos_referencia_aberta	/pt-BR/docs/Archive/B2G_OS/Developing_Firefox_OS/Melhores_praticas_dispositivos_referencia_aberta
/pt-BR/docs/Mozilla/B2G_OS/Developing_Firefox_OS/Recursos_dispositivos_Firefox_OS	/pt-BR/docs/Archive/B2G_OS/Developing_Firefox_OS/Recursos_dispositivos_Firefox_OS
/pt-BR/docs/Mozilla/B2G_OS/Developing_Firefox_OS/ZTE_OPEN	/pt-BR/docs/Archive/B2G_OS/Developing_Firefox_OS/ZTE_OPEN
/pt-BR/docs/Mozilla/B2G_OS/Developing_Firefox_OS/ZTE_OPEN_C	/pt-BR/docs/Archive/B2G_OS/Developing_Firefox_OS/ZTE_OPEN_C
/pt-BR/docs/Mozilla/B2G_OS/Dual_Boot_B2G_Android_SGS2	/pt-BR/docs/Archive/B2G_OS/Dual_Boot_B2G_Android_SGS2
/pt-BR/docs/Mozilla/B2G_OS/Escolhendo_como_executar_Gaia_ou_B2G	/pt-BR/docs/Archive/B2G_OS/Escolhendo_como_executar_Gaia_ou_B2G
/pt-BR/docs/Mozilla/B2G_OS/FAQ_Firefox_OS	/pt-BR/docs/Archive/B2G_OS/FAQ_Firefox_OS
/pt-BR/docs/Mozilla/B2G_OS/Firefox_OS_build_prerequisites	/pt-BR/docs/Archive/B2G_OS/Firefox_OS_build_prerequisites
/pt-BR/docs/Mozilla/B2G_OS/Firefox_OS_usage_tips	/pt-BR/docs/Archive/B2G_OS/Firefox_OS_usage_tips
/pt-BR/docs/Mozilla/B2G_OS/Guia_Gaia_hacking	/pt-BR/docs/Archive/B2G_OS/Guia_Gaia_hacking
/pt-BR/docs/Mozilla/B2G_OS/Instalando_B2G_Pandaboard	/pt-BR/docs/Archive/B2G_OS/Instalando_B2G_Pandaboard
/pt-BR/docs/Mozilla/B2G_OS/Instalando_FirefoxOS_dispositivo_movel	/pt-BR/docs/Archive/B2G_OS/Instalando_FirefoxOS_dispositivo_movel
/pt-BR/docs/Mozilla/B2G_OS/Introdução	/pt-BR/docs/Archive/B2G_OS/Introdu%C3%A7%C3%A3o
/pt-BR/docs/Mozilla/B2G_OS/Platform	/pt-BR/docs/Archive/B2G_OS/Platform
/pt-BR/docs/Mozilla/B2G_OS/Platform/Architecture	/pt-BR/docs/Archive/B2G_OS/Platform/Architecture
/pt-BR/docs/Mozilla/B2G_OS/Platform/Arquitetura_aplicacoes_Firefox_OS	/pt-BR/docs/Archive/B2G_OS/Platform/Arquitetura_aplicacoes_Firefox_OS
/pt-BR/docs/Mozilla/B2G_OS/Platform/Automated_testing	/pt-BR/docs/Archive/B2G_OS/Platform/Automated_testing
/pt-BR/docs/Mozilla/B2G_OS/Platform/Automated_testing/Configurando_Marionette	/pt-BR/docs/Archive/B2G_OS/Platform/Automated_testing/Configurando_Marionette
/pt-BR/docs/Mozilla/B2G_OS/Platform/Automated_testing/Gaia_unit_tests	/pt-BR/docs/Archive/B2G_OS/Platform/Automated_testing/Gaia_unit_tests
/pt-BR/docs/Mozilla/B2G_OS/Platform/Automated_testing/Mochitests	/pt-BR/docs/Archive/B2G_OS/Platform/Automated_testing/Mochitests
/pt-BR/docs/Mozilla/B2G_OS/Platform/Automated_testing/gaia-ui-tests	/pt-BR/docs/Archive/B2G_OS/Platform/Automated_testing/gaia-ui-tests
/pt-BR/docs/Mozilla/B2G_OS/Platform/Automated_testing/gaia-ui-tests/Parte_1_Iniciando_Marionette_Firefox_OS	/pt-BR/docs/Archive/B2G_OS/Platform/Automated_testing/gaia-ui-tests/Parte_1_Iniciando_Marionette_Firefox_OS
/pt-BR/docs/Mozilla/B2G_OS/Platform/Automated_testing/gaia-ui-tests/Testes_IU_Gaia_Executando_Testes	/pt-BR/docs/Archive/B2G_OS/Platform/Automated_testing/gaia-ui-tests/Testes_IU_Gaia_Executando_Testes
/pt-BR/docs/Mozilla/B2G_OS/Platform/Gaia	/pt-BR/docs/Archive/B2G_OS/Platform/Gaia
/pt-BR/docs/Mozilla/B2G_OS/Platform/Gaia/Gaia_apps	/pt-BR/docs/Archive/B2G_OS/Platform/Gaia/Gaia_apps
/pt-BR/docs/Mozilla/B2G_OS/Platform/Gaia/Gaia_apps/Navegador	/pt-BR/docs/Archive/B2G_OS/Platform/Gaia/Gaia_apps/Navegador
/pt-BR/docs/Mozilla/B2G_OS/Platform/Gaia/Gaia_apps/Sistema	/pt-BR/docs/Archive/B2G_OS/Platform/Gaia/Gaia_apps/Sistema
/pt-BR/docs/Mozilla/B2G_OS/Platform/Gaia/Gaia_apps/Video	/pt-BR/docs/Archive/B2G_OS/Platform/Gaia/Gaia_apps/Video
/pt-BR/docs/Mozilla/B2G_OS/Platform/Gaia/Gaia_apps/Window_Management	/pt-BR/docs/Archive/B2G_OS/Platform/Gaia/Gaia_apps/Window_Management
/pt-BR/docs/Mozilla/B2G_OS/Platform/Gaia/Hacking	/pt-BR/docs/Archive/B2G_OS/Platform/Gaia/Hacking
/pt-BR/docs/Mozilla/B2G_OS/Platform/Gaia/Introducao_ao_Gaia	/pt-BR/docs/Archive/B2G_OS/Platform/Gaia/Introducao_ao_Gaia
/pt-BR/docs/Mozilla/B2G_OS/Platform/Gaia/Sistema_compilacao_primario	/pt-BR/docs/Archive/B2G_OS/Platform/Gaia/Sistema_compilacao_primario
/pt-BR/docs/Mozilla/B2G_OS/Platform/Gonk	/pt-BR/docs/Archive/B2G_OS/Platform/Gonk
/pt-BR/docs/Mozilla/B2G_OS/Platform/Lista_Configuracao	/pt-BR/docs/Archive/B2G_OS/Platform/Lista_Configuracao
/pt-BR/docs/Mozilla/B2G_OS/Platform/Out_of_memory_management_on_Firefox_OS	/pt-BR/docs/Archive/B2G_OS/Platform/Out_of_memory_management_on_Firefox_OS
/pt-BR/docs/Mozilla/B2G_OS/Platform/tabela_funcionalidades	/pt-BR/docs/Archive/B2G_OS/Platform/tabela_funcionalidades
/pt-BR/docs/Mozilla/B2G_OS/Porting	/pt-BR/docs/Archive/B2G_OS/Porting
/pt-BR/docs/Mozilla/B2G_OS/Preparando_sua_primeira_compilacao_do_B2G	/pt-BR/docs/Archive/B2G_OS/Preparando_sua_primeira_compilacao_do_B2G
/pt-BR/docs/Mozilla/B2G_OS/Releases	/pt-BR/docs/Archive/B2G_OS/Releases
/pt-BR/docs/Mozilla/B2G_OS/Releases/1.0.1	/pt-BR/docs/Archive/B2G_OS/Releases/1.0.1
/pt-BR/docs/Mozilla/B2G_OS/Releases/1.1	/pt-BR/docs/Archive/B2G_OS/Releases/1.1
/pt-BR/docs/Mozilla/B2G_OS/Releases/1.3	/pt-BR/docs/Archive/B2G_OS/Releases/1.3
/pt-BR/docs/Mozilla/B2G_OS/Releases/2.0	/pt-BR/docs/Archive/B2G_OS/Releases/2.0
/pt-BR/docs/Mozilla/B2G_OS/Releases/2.1	/pt-BR/docs/Archive/B2G_OS/Releases/2.1
/pt-BR/docs/Mozilla/B2G_OS/Screencast_series:_App_Basics_for_Firefox_OS	/pt-BR/docs/Archive/B2G_OS/Screencast_series:_App_Basics_for_Firefox_OS
/pt-BR/docs/Mozilla/B2G_OS/Security	/pt-BR/docs/Archive/B2G_OS/Security
/pt-BR/docs/Mozilla/B2G_OS/Security/Installing_and_updating_applications	/pt-BR/docs/Archive/B2G_OS/Security/Installing_and_updating_applications
/pt-BR/docs/Mozilla/B2G_OS/Security/Seguranca_de_aplicacao	/pt-BR/docs/Archive/B2G_OS/Security/Seguranca_de_aplicacao
/pt-BR/docs/Mozilla/B2G_OS/Security/modelo_de_seguranca	/pt-BR/docs/Archive/B2G_OS/Security/modelo_de_seguranca
/pt-BR/docs/Mozilla/B2G_OS/Televisoes_e_dispositivos_conectados	/pt-BR/docs/Archive/B2G_OS/Televisoes_e_dispositivos_conectados
/pt-BR/docs/Mozilla/B2G_OS/Testes_Firefox_OS_guia_desenvolvedores	/pt-BR/docs/Archive/B2G_OS/Testes_Firefox_OS_guia_desenvolvedores
/pt-BR/docs/Mozilla/B2G_OS/Tips_and_tricks	/pt-BR/docs/Archive/B2G_OS/Tips_and_tricks
/pt-BR/docs/Mozilla/B2G_OS/Usande_emuladores_Firefox_OS	/pt-BR/docs/Archive/B2G_OS/Usande_emuladores_Firefox_OS
/pt-BR/docs/Mozilla/B2G_OS/Usando_o_App_Manager	/pt-BR/docs/Archive/B2G_OS/Usando_o_App_Manager
/pt-BR/docs/Mozilla/B2G_OS/Usando_o_cliente_B2G_Desktop	/pt-BR/docs/Archive/B2G_OS/Usando_o_cliente_B2G_Desktop
/pt-BR/docs/Mozilla/B2G_OS/br	/pt-BR/docs/Archive/B2G_OS/br
/pt-BR/docs/Mozilla/B2G_OS/modifying_hosts_file	/pt-BR/docs/Archive/B2G_OS/modifying_hosts_file
/pt-BR/docs/Mozilla/Boot_to_Gecko/Application_development	/pt-BR/docs/Mozilla/B2G_OS/Application_development
/pt-BR/docs/Mozilla/Boot_to_Gecko/Boot_to_Gecko_developer_phone_guide	/pt-BR/Firefox_OS/Developing_Firefox_OS
/pt-BR/docs/Mozilla/Boot_to_Gecko/Boot_to_Gecko_developer_phone_guide/Especificacoes_Telefones	/pt-BR/Firefox_OS/Developing_Firefox_OS/Especificacoes_Telefones
/pt-BR/docs/Mozilla/Boot_to_Gecko/Boot_to_Gecko_developer_phone_guide/Melhores_praticas_dispositivos_referencia_aberta	/pt-BR/Firefox_OS/Developing_Firefox_OS/Melhores_praticas_dispositivos_referencia_aberta
/pt-BR/docs/Mozilla/Boot_to_Gecko/Boot_to_Gecko_developer_phone_guide/Recursos_dispositivos_Firefox_OS	/pt-BR/Firefox_OS/Developing_Firefox_OS/Recursos_dispositivos_Firefox_OS
/pt-BR/docs/Mozilla/Boot_to_Gecko/Desenvolvimento_aplicações	/pt-BR/docs/Mozilla/Boot_to_Gecko/Application_development
/pt-BR/docs/Mozilla/Boot_to_Gecko/Firefox_OS_build_prerequisites	/pt-BR/Firefox_OS/Firefox_OS_build_prerequisites
/pt-BR/docs/Mozilla/Boot_to_Gecko/Firefox_OS_rodando_prerequisitos	/pt-BR/docs/Mozilla/Boot_to_Gecko/Firefox_OS_build_prerequisites
/pt-BR/docs/Mozilla/Boot_to_Gecko/Guia_Gaia_hacking	/pt-BR/docs/Mozilla/B2G_OS/Guia_Gaia_hacking
/pt-BR/docs/Mozilla/Boot_to_Gecko/Introduction	/pt-BR/Firefox_OS/Introdu%C3%A7%C3%A3o
/pt-BR/docs/Mozilla/Boot_to_Gecko/Introdução	/pt-BR/docs/Mozilla/Boot_to_Gecko/Introduction
/pt-BR/docs/Mozilla/Boot_to_Gecko/Using_the_B2G_desktop_client	/pt-BR/Firefox_OS/Usando_o_cliente_B2G_Desktop
/pt-BR/docs/Mozilla/Boot_to_Gecko/Using_the_B2G_emulators	/pt-BR/Firefox_OS/Usande_emuladores_Firefox_OS
/pt-BR/docs/Mozilla/Boot_to_Gecko/usando_emuladores_b2g	/pt-BR/docs/Mozilla/Boot_to_Gecko/Using_the_B2G_emulators
/pt-BR/docs/Mozilla/Developer_guide/Introducao	/pt-BR/docs/Mozilla/Developer_guide/Introduction
/pt-BR/docs/Mozilla/Firefox_OS	/pt-BR/docs/Mozilla/B2G_OS
/pt-BR/docs/Mozilla/Firefox_OS/Add-ons	/pt-BR/docs/Mozilla/B2G_OS/Add-ons
/pt-BR/docs/Mozilla/Firefox_OS/Apps	/pt-BR/docs/Mozilla/B2G_OS/Apps
/pt-BR/docs/Mozilla/Firefox_OS/Apps/Writing_a_web_app_for_Firefox_OS	/pt-BR/docs/Mozilla/B2G_OS/Apps/Writing_a_web_app_for_Firefox_OS
/pt-BR/docs/Mozilla/Firefox_OS/Architecture	/pt-BR/docs/Mozilla/B2G_OS/Platform/Architecture
/pt-BR/docs/Mozilla/Firefox_OS/Atualizando_telefone_desenvolvimento	/pt-BR/docs/Mozilla/B2G_OS/Atualizando_telefone_desenvolvimento
/pt-BR/docs/Mozilla/Firefox_OS/Comecando_a_contribuir_para_o_Firefox_OS	/pt-BR/docs/Mozilla/B2G_OS/Comecando_a_contribuir_para_o_Firefox_OS
/pt-BR/docs/Mozilla/Firefox_OS/Compilando_B2G_Emulador_QEMU	/pt-BR/docs/Mozilla/B2G_OS/Compilando_B2G_Emulador_QEMU
/pt-BR/docs/Mozilla/Firefox_OS/Compilando_O_Firefox_OS	/pt-BR/docs/Mozilla/B2G_OS/Compilando_O_Firefox_OS
/pt-BR/docs/Mozilla/Firefox_OS/Compilando_e_instalando_o_Firefox_OS	/pt-BR/docs/Mozilla/B2G_OS/Compilando_e_instalando_o_Firefox_OS
/pt-BR/docs/Mozilla/Firefox_OS/Compilando_instalando_Firefox_OS	/pt-BR/docs/Mozilla/B2G_OS/Compilando_instalando_Firefox_OS
/pt-BR/docs/Mozilla/Firefox_OS/Construindo_e_instalando_o_Firefox_OS	/pt-BR/docs/Mozilla/B2G_OS/Construindo_e_instalando_o_Firefox_OS
/pt-BR/docs/Mozilla/Firefox_OS/Construindo_e_instalando_o_Firefox_OS/Compilando_o_Firefox_OS_para_o_Flame_no_OSX	/pt-BR/docs/Mozilla/B2G_OS/Construindo_e_instalando_o_Firefox_OS/Compilando_o_Firefox_OS_para_o_Flame_no_OSX
/pt-BR/docs/Mozilla/Firefox_OS/Construindo_e_instalando_o_Firefox_OS/Criando_e_aplicando_pacotes_de_atualizacao_Firefox_OS	/pt-BR/docs/Mozilla/B2G_OS/Construindo_e_instalando_o_Firefox_OS/Criando_e_aplicando_pacotes_de_atualizacao_Firefox_OS
/pt-BR/docs/Mozilla/Firefox_OS/Construindo_e_instalando_o_Firefox_OS/visao_geral_compilacao_firefox_os	/pt-BR/docs/Mozilla/B2G_OS/Construindo_e_instalando_o_Firefox_OS/visao_geral_compilacao_firefox_os
/pt-BR/docs/Mozilla/Firefox_OS/Correções	/pt-BR/docs/Mozilla/B2G_OS/Corre%C3%A7%C3%B5es
/pt-BR/docs/Mozilla/Firefox_OS/Customizacao_com_o_arquivo_.userconfig_file	/pt-BR/docs/Mozilla/B2G_OS/Customizacao_com_o_arquivo_.userconfig_file
/pt-BR/docs/Mozilla/Firefox_OS/Debugging	/pt-BR/docs/Mozilla/B2G_OS/Debugging
/pt-BR/docs/Mozilla/Firefox_OS/Debugging/Conectando_um_dispositivo_com_Firefox_OS_no_desktop	/pt-BR/docs/Mozilla/B2G_OS/Debugging/Conectando_um_dispositivo_com_Firefox_OS_no_desktop
/pt-BR/docs/Mozilla/Firefox_OS/Debugging/Configurando	/pt-BR/docs/Mozilla/B2G_OS/Debugging/Configurando
/pt-BR/docs/Mozilla/Firefox_OS/Debugging/Configurações_do_Desenvolvedor	/pt-BR/docs/Mozilla/B2G_OS/Debugging/Configura%C3%A7%C3%B5es_do_Desenvolvedor
/pt-BR/docs/Mozilla/Firefox_OS/Debugging/Debugging_B2G_using_valgrind	/pt-BR/docs/Mozilla/B2G_OS/Debugging/Debugging_B2G_using_valgrind
/pt-BR/docs/Mozilla/Firefox_OS/Debugging/Depurando_B2G_usando_gdb	/pt-BR/docs/Mozilla/B2G_OS/Debugging/Depurando_B2G_usando_gdb
/pt-BR/docs/Mozilla/Firefox_OS/Debugging/Depurando_erros_falta_de_memoria	/pt-BR/docs/Mozilla/B2G_OS/Debugging/Depurando_erros_falta_de_memoria
/pt-BR/docs/Mozilla/Firefox_OS/Debugging/Firefox_OS_crash_reporting	/pt-BR/docs/Mozilla/B2G_OS/Debugging/Firefox_OS_crash_reporting
/pt-BR/docs/Mozilla/Firefox_OS/Debugging/Instalando_ADB	/pt-BR/docs/Mozilla/B2G_OS/Debugging/Instalando_ADB
/pt-BR/docs/Mozilla/Firefox_OS/Debugging/Intercepting_traffic_using_a_proxy	/pt-BR/docs/Mozilla/B2G_OS/Debugging/Intercepting_traffic_using_a_proxy
/pt-BR/docs/Mozilla/Firefox_OS/Debugging/Log_console_no_dispositivo	/pt-BR/docs/Mozilla/B2G_OS/Debugging/Log_console_no_dispositivo
/pt-BR/docs/Mozilla/Firefox_OS/Debugging/Taking_screenshots	/pt-BR/docs/Mozilla/B2G_OS/Debugging/Taking_screenshots
/pt-BR/docs/Mozilla/Firefox_OS/Desenvolvendo_Gaia	/pt-BR/docs/Mozilla/B2G_OS/Desenvolvendo_Gaia
/pt-BR/docs/Mozilla/Firefox_OS/Desenvolvendo_Gaia/Alterando_aplicativos_empacotados_compilacao_imagem	/pt-BR/docs/Mozilla/B2G_OS/Desenvolvendo_Gaia/Alterando_aplicativos_empacotados_compilacao_imagem
/pt-BR/docs/Mozilla/Firefox_OS/Desenvolvendo_Gaia/Diferente_formas_executar_Gaia	/pt-BR/docs/Mozilla/B2G_OS/Desenvolvendo_Gaia/Diferente_formas_executar_Gaia
/pt-BR/docs/Mozilla/Firefox_OS/Desenvolvendo_Gaia/Entendendo_codebase_gaia	/pt-BR/docs/Mozilla/B2G_OS/Desenvolvendo_Gaia/Entendendo_codebase_gaia
/pt-BR/docs/Mozilla/Firefox_OS/Desenvolvendo_Gaia/Executando_codebase_Gaia	/pt-BR/docs/Mozilla/B2G_OS/Desenvolvendo_Gaia/Executando_codebase_Gaia
/pt-BR/docs/Mozilla/Firefox_OS/Desenvolvendo_Gaia/Fazendo_alteracoes_codigo_Gaia	/pt-BR/docs/Mozilla/B2G_OS/Desenvolvendo_Gaia/Fazendo_alteracoes_codigo_Gaia
/pt-BR/docs/Mozilla/Firefox_OS/Desenvolvendo_Gaia/Ferramentas_Gaia	/pt-BR/docs/Mozilla/B2G_OS/Desenvolvendo_Gaia/Ferramentas_Gaia
/pt-BR/docs/Mozilla/Firefox_OS/Desenvolvendo_Gaia/Submetendo_correcao_Gaia	/pt-BR/docs/Mozilla/B2G_OS/Desenvolvendo_Gaia/Submetendo_correcao_Gaia
/pt-BR/docs/Mozilla/Firefox_OS/Desenvolvendo_Gaia/Testando_alteracoes_gaia	/pt-BR/docs/Mozilla/B2G_OS/Desenvolvendo_Gaia/Testando_alteracoes_gaia
/pt-BR/docs/Mozilla/Firefox_OS/Desenvolvendo_Gaia/melhores_praticas_localizacao_gaia	/pt-BR/docs/Mozilla/B2G_OS/Desenvolvendo_Gaia/melhores_praticas_localizacao_gaia
/pt-BR/docs/Mozilla/Firefox_OS/Desenvolvendo_Gaia/referencia_opcoes_make	/pt-BR/docs/Mozilla/B2G_OS/Desenvolvendo_Gaia/referencia_opcoes_make
/pt-BR/docs/Mozilla/Firefox_OS/Desenvolvendo_no_Firefox_OS	/pt-BR/docs/Mozilla/B2G_OS/Desenvolvendo_no_Firefox_OS
/pt-BR/docs/Mozilla/Firefox_OS/Desenvolvendo_no_Firefox_OS/Customizando_script_b2g.sh	/pt-BR/docs/Mozilla/B2G_OS/Desenvolvendo_no_Firefox_OS/Customizando_script_b2g.sh
/pt-BR/docs/Mozilla/Firefox_OS/Desenvolvendo_no_Firefox_OS/Firefox_OS_bugwork	/pt-BR/docs/Mozilla/B2G_OS/Desenvolvendo_no_Firefox_OS/Firefox_OS_bugwork
/pt-BR/docs/Mozilla/Firefox_OS/Desenvolvendo_no_Firefox_OS/Guia_customizacao_imagem_Firefox_OS	/pt-BR/docs/Mozilla/B2G_OS/Desenvolvendo_no_Firefox_OS/Guia_customizacao_imagem_Firefox_OS
/pt-BR/docs/Mozilla/Firefox_OS/Desenvolvendo_no_Firefox_OS/Personalizando_teclado_aplicativos_FirefoxOS	/pt-BR/docs/Mozilla/B2G_OS/Desenvolvendo_no_Firefox_OS/Personalizando_teclado_aplicativos_FirefoxOS_h
/pt-BR/docs/Mozilla/Firefox_OS/Desenvolvendo_no_Firefox_OS/Quickstart_guide_to_B2G_development	/pt-BR/docs/Mozilla/B2G_OS/Desenvolvendo_no_Firefox_OS/Quickstart_guide_to_B2G_development
/pt-BR/docs/Mozilla/Firefox_OS/Developer_phone_guide/Geeksphone	/pt-BR/docs/Mozilla/B2G_OS/Developing_Firefox_OS/Geeksphone
/pt-BR/docs/Mozilla/Firefox_OS/Developer_phone_guide/Geeksphone/Perguntas_Frequentes_Geeksphone	/pt-BR/docs/Mozilla/B2G_OS/Developing_Firefox_OS/Geeksphone/Perguntas_Frequentes_Geeksphone
/pt-BR/docs/Mozilla/Firefox_OS/Developing_Firefox_OS	/pt-BR/docs/Mozilla/B2G_OS/Developing_Firefox_OS
/pt-BR/docs/Mozilla/Firefox_OS/Developing_Firefox_OS/Especificacoes_Telefones	/pt-BR/docs/Mozilla/B2G_OS/Developing_Firefox_OS/Especificacoes_Telefones
/pt-BR/docs/Mozilla/Firefox_OS/Developing_Firefox_OS/Fairphone	/pt-BR/docs/Mozilla/B2G_OS/Developing_Firefox_OS/Fairphone
/pt-BR/docs/Mozilla/Firefox_OS/Developing_Firefox_OS/Flame	/pt-BR/docs/Mozilla/B2G_OS/Developing_Firefox_OS/Flame
/pt-BR/docs/Mozilla/Firefox_OS/Developing_Firefox_OS/Guia_rapido_desenvolvimento_Gaia	/pt-BR/docs/Mozilla/B2G_OS/Desenvolvendo_no_Firefox_OS/Guia_rapido_desenvolvimento_Gaia
/pt-BR/docs/Mozilla/Firefox_OS/Developing_Firefox_OS/Localizando_Firefox_OS	/pt-BR/docs/Mozilla/B2G_OS/Desenvolvendo_no_Firefox_OS/Localizando_Firefox_OS
/pt-BR/docs/Mozilla/Firefox_OS/Developing_Firefox_OS/Melhores_praticas_dispositivos_referencia_aberta	/pt-BR/docs/Mozilla/B2G_OS/Developing_Firefox_OS/Melhores_praticas_dispositivos_referencia_aberta
/pt-BR/docs/Mozilla/Firefox_OS/Developing_Firefox_OS/Personalizando_teclado_aplicativos_FirefoxOS	/pt-BR/docs/Mozilla/B2G_OS/Desenvolvendo_no_Firefox_OS/Personalizando_teclado_aplicativos_FirefoxOS
/pt-BR/docs/Mozilla/Firefox_OS/Developing_Firefox_OS/Recursos_dispositivos_Firefox_OS	/pt-BR/docs/Mozilla/B2G_OS/Developing_Firefox_OS/Recursos_dispositivos_Firefox_OS
/pt-BR/docs/Mozilla/Firefox_OS/Developing_Firefox_OS/ZTE_OPEN	/pt-BR/docs/Mozilla/B2G_OS/Developing_Firefox_OS/ZTE_OPEN
/pt-BR/docs/Mozilla/Firefox_OS/Developing_Firefox_OS/ZTE_OPEN_C	/pt-BR/docs/Mozilla/B2G_OS/Developing_Firefox_OS/ZTE_OPEN_C
/pt-BR/docs/Mozilla/Firefox_OS/Dual_Boot_B2G_Android_SGS2	/pt-BR/docs/Mozilla/B2G_OS/Dual_Boot_B2G_Android_SGS2
/pt-BR/docs/Mozilla/Firefox_OS/Escolhendo_como_executar_Gaia_ou_B2G	/pt-BR/docs/Mozilla/B2G_OS/Escolhendo_como_executar_Gaia_ou_B2G
/pt-BR/docs/Mozilla/Firefox_OS/FAQ_Firefox_OS	/pt-BR/docs/Mozilla/B2G_OS/FAQ_Firefox_OS
/pt-BR/docs/Mozilla/Firefox_OS/Firefox_OS_build_prerequisites	/pt-BR/docs/Mozilla/B2G_OS/Firefox_OS_build_prerequisites
/pt-BR/docs/Mozilla/Firefox_OS/Firefox_OS_usage_tips	/pt-BR/docs/Mozilla/B2G_OS/Firefox_OS_usage_tips
/pt-BR/docs/Mozilla/Firefox_OS/Firefox_OS_usage_tips/depurando_remotamente	/pt-BR/docs/Mozilla/B2G_OS/Firefox_OS_usage_tips/depurando_remotamente
/pt-BR/docs/Mozilla/Firefox_OS/Instalando_B2G_Pandaboard	/pt-BR/docs/Mozilla/B2G_OS/Instalando_B2G_Pandaboard
/pt-BR/docs/Mozilla/Firefox_OS/Instalando_FirefoxOS_dispositivo_movel	/pt-BR/docs/Mozilla/B2G_OS/Instalando_FirefoxOS_dispositivo_movel
/pt-BR/docs/Mozilla/Firefox_OS/Introdução	/pt-BR/docs/Mozilla/B2G_OS/Introdu%C3%A7%C3%A3o
/pt-BR/docs/Mozilla/Firefox_OS/Platform	/pt-BR/docs/Mozilla/B2G_OS/Platform
/pt-BR/docs/Mozilla/Firefox_OS/Platform/Arquitetura_aplicacoes_Firefox_OS	/pt-BR/docs/Mozilla/B2G_OS/Platform/Arquitetura_aplicacoes_Firefox_OS
/pt-BR/docs/Mozilla/Firefox_OS/Platform/Automated_testing	/pt-BR/docs/Mozilla/B2G_OS/Platform/Automated_testing
/pt-BR/docs/Mozilla/Firefox_OS/Platform/Automated_testing/Configurando_Marionette	/pt-BR/docs/Mozilla/B2G_OS/Platform/Automated_testing/Configurando_Marionette
/pt-BR/docs/Mozilla/Firefox_OS/Platform/Automated_testing/Gaia_unit_tests	/pt-BR/docs/Mozilla/B2G_OS/Platform/Automated_testing/Gaia_unit_tests
/pt-BR/docs/Mozilla/Firefox_OS/Platform/Automated_testing/Mochitests	/pt-BR/docs/Mozilla/B2G_OS/Platform/Automated_testing/Mochitests
/pt-BR/docs/Mozilla/Firefox_OS/Platform/Automated_testing/gaia-ui-tests	/pt-BR/docs/Mozilla/B2G_OS/Platform/Automated_testing/gaia-ui-tests
/pt-BR/docs/Mozilla/Firefox_OS/Platform/Automated_testing/gaia-ui-tests/Parte_1_Iniciando_Marionette_Firefox_OS	/pt-BR/docs/Mozilla/B2G_OS/Platform/Automated_testing/gaia-ui-tests/Parte_1_Iniciando_Marionette_Firefox_OS
/pt-BR/docs/Mozilla/Firefox_OS/Platform/Automated_testing/gaia-ui-tests/Testes_IU_Gaia_Executando_Testes	/pt-BR/docs/Mozilla/B2G_OS/Platform/Automated_testing/gaia-ui-tests/Testes_IU_Gaia_Executando_Testes
/pt-BR/docs/Mozilla/Firefox_OS/Platform/Gaia	/pt-BR/docs/Mozilla/B2G_OS/Platform/Gaia
/pt-BR/docs/Mozilla/Firefox_OS/Platform/Gaia/Gaia_apps	/pt-BR/docs/Mozilla/B2G_OS/Platform/Gaia/Gaia_apps
/pt-BR/docs/Mozilla/Firefox_OS/Platform/Gaia/Gaia_apps/Navegador	/pt-BR/docs/Mozilla/B2G_OS/Platform/Gaia/Gaia_apps/Navegador
/pt-BR/docs/Mozilla/Firefox_OS/Platform/Gaia/Gaia_apps/Sistema	/pt-BR/docs/Mozilla/B2G_OS/Platform/Gaia/Gaia_apps/Sistema
/pt-BR/docs/Mozilla/Firefox_OS/Platform/Gaia/Gaia_apps/Video	/pt-BR/docs/Mozilla/B2G_OS/Platform/Gaia/Gaia_apps/Video
/pt-BR/docs/Mozilla/Firefox_OS/Platform/Gaia/Gaia_apps/Window_Management	/pt-BR/docs/Mozilla/B2G_OS/Platform/Gaia/Gaia_apps/Window_Management
/pt-BR/docs/Mozilla/Firefox_OS/Platform/Gaia/Hacking	/pt-BR/docs/Mozilla/B2G_OS/Platform/Gaia/Hacking
/pt-BR/docs/Mozilla/Firefox_OS/Platform/Gaia/Introducao_ao_Gaia	/pt-BR/docs/Mozilla/B2G_OS/Platform/Gaia/Introducao_ao_Gaia
/pt-BR/docs/Mozilla/Firefox_OS/Platform/Gaia/Sistema_compilacao_primario	/pt-BR/docs/Mozilla/B2G_OS/Platform/Gaia/Sistema_compilacao_primario
/pt-BR/docs/Mozilla/Firefox_OS/Platform/Gonk	/pt-BR/docs/Mozilla/B2G_OS/Platform/Gonk
/pt-BR/docs/Mozilla/Firefox_OS/Platform/Lista_Configuracao	/pt-BR/docs/Mozilla/B2G_OS/Platform/Lista_Configuracao
/pt-BR/docs/Mozilla/Firefox_OS/Platform/Out_of_memory_management_on_Firefox_OS	/pt-BR/docs/Mozilla/B2G_OS/Platform/Out_of_memory_management_on_Firefox_OS
/pt-BR/docs/Mozilla/Firefox_OS/Platform/tabela_funcionalidades	/pt-BR/docs/Mozilla/B2G_OS/Platform/tabela_funcionalidades
/pt-BR/docs/Mozilla/Firefox_OS/Porting	/pt-BR/docs/Mozilla/B2G_OS/Porting
/pt-BR/docs/Mozilla/Firefox_OS/Preparando_sua_primeira_compilacao_do_B2G	/pt-BR/docs/Mozilla/B2G_OS/Preparando_sua_primeira_compilacao_do_B2G
/pt-BR/docs/Mozilla/Firefox_OS/Releases	/pt-BR/docs/Mozilla/B2G_OS/Releases
/pt-BR/docs/Mozilla/Firefox_OS/Releases/1.0.1	/pt-BR/docs/Mozilla/B2G_OS/Releases/1.0.1
/pt-BR/docs/Mozilla/Firefox_OS/Releases/1.1	/pt-BR/docs/Mozilla/B2G_OS/Releases/1.1
/pt-BR/docs/Mozilla/Firefox_OS/Releases/1.3	/pt-BR/docs/Mozilla/B2G_OS/Releases/1.3
/pt-BR/docs/Mozilla/Firefox_OS/Releases/2.0	/pt-BR/docs/Mozilla/B2G_OS/Releases/2.0
/pt-BR/docs/Mozilla/Firefox_OS/Releases/2.1	/pt-BR/docs/Mozilla/B2G_OS/Releases/2.1
/pt-BR/docs/Mozilla/Firefox_OS/Screencast_series:_App_Basics_for_Firefox_OS	/pt-BR/docs/Mozilla/B2G_OS/Screencast_series:_App_Basics_for_Firefox_OS
/pt-BR/docs/Mozilla/Firefox_OS/Security	/pt-BR/docs/Mozilla/B2G_OS/Security
/pt-BR/docs/Mozilla/Firefox_OS/Security/Installing_and_updating_applications	/pt-BR/docs/Mozilla/B2G_OS/Security/Installing_and_updating_applications
/pt-BR/docs/Mozilla/Firefox_OS/Security/Seguranca_de_aplicacao	/pt-BR/docs/Mozilla/B2G_OS/Security/Seguranca_de_aplicacao
/pt-BR/docs/Mozilla/Firefox_OS/Security/modelo_de_seguranca	/pt-BR/docs/Mozilla/B2G_OS/Security/modelo_de_seguranca
/pt-BR/docs/Mozilla/Firefox_OS/Televisoes_e_dispositivos_conectados	/pt-BR/docs/Mozilla/B2G_OS/Televisoes_e_dispositivos_conectados
/pt-BR/docs/Mozilla/Firefox_OS/Testes_Firefox_OS_guia_desenvolvedores	/pt-BR/docs/Mozilla/B2G_OS/Testes_Firefox_OS_guia_desenvolvedores
/pt-BR/docs/Mozilla/Firefox_OS/Tips_and_tricks	/pt-BR/docs/Mozilla/B2G_OS/Tips_and_tricks
/pt-BR/docs/Mozilla/Firefox_OS/Tips_and_tricks/modifying_hosts_file	/pt-BR/Firefox_OS/modifying_hosts_file
/pt-BR/docs/Mozilla/Firefox_OS/Tips_and_tricks/taking_screenshots	/pt-BR/Firefox_OS/Debugging/Taking_screenshots
/pt-BR/docs/Mozilla/Firefox_OS/Usande_emuladores_Firefox_OS	/pt-BR/docs/Mozilla/B2G_OS/Usande_emuladores_Firefox_OS
/pt-BR/docs/Mozilla/Firefox_OS/Usando_o_App_Manager	/pt-BR/docs/Mozilla/B2G_OS/Usando_o_App_Manager
/pt-BR/docs/Mozilla/Firefox_OS/Usando_o_cliente_B2G_Desktop	/pt-BR/docs/Mozilla/B2G_OS/Usando_o_cliente_B2G_Desktop
/pt-BR/docs/Mozilla/Firefox_OS/br	/pt-BR/docs/Mozilla/B2G_OS/br
/pt-BR/docs/Mozilla/Firefox_OS/modifying_hosts_file	/pt-BR/docs/Mozilla/B2G_OS/modifying_hosts_file
/pt-BR/docs/Mozilla/Programa_Desenvolvimento	/pt-BR/docs/Mozilla/Connect
/pt-BR/docs/Mozilla/QA/Fuzzing	/pt-BR/docs/Glossario/Fuzzing
/pt-BR/docs/Mozilla/Tech/XUL	/pt-BR/docs/Archive/Mozilla/XUL
/pt-BR/docs/Mozilla/Tech/XUL/Namespaces	/pt-BR/docs/Archive/Mozilla/XUL/Namespaces
/pt-BR/docs/Mozilla/Tech/XUL/Navegador	/pt-BR/docs/Archive/Mozilla/XUL/Navegador
/pt-BR/docs/Mozilla/Tech/XUL/Tutorial	/pt-BR/docs/Archive/Mozilla/XUL/Tutorial
/pt-BR/docs/Mozilla/Tech/XUL/Tutorial/Localização	/pt-BR/docs/Archive/Mozilla/XUL/Tutorial/Localiza%C3%A7%C3%A3o
/pt-BR/docs/Mozilla/Tech/XUL/XUL_Reference	/pt-BR/docs/Archive/Mozilla/XUL/XUL_Reference
/pt-BR/docs/Online_and_offline_events	/pt-BR/docs/Web/API/NavigatorOnLine/Online_and_offline_events
/pt-BR/docs/Persona	/pt-BR/docs/Mozilla/Persona
/pt-BR/docs/Persona/.well-known-browserid	/pt-BR/docs/Mozilla/Persona/.well-known-browserid
/pt-BR/docs/Persona/Quick_Setup	/pt-BR/docs/Mozilla/Persona/Quick_Setup
/pt-BR/docs/Persona/User_interface_guidelines	/pt-BR/docs/Mozilla/Persona/User_interface_guidelines
/pt-BR/docs/Project:MDN	/pt-BR/docs/MDN
/pt-BR/docs/Project:MDN/Style_guide	/en-US/docs/MDN/Contribute/Content/Style_guide
/pt-BR/docs/Projeto:Como_ajudar_com_MDN-redirect-1	/pt-BR/docs/Projeto:Como_ajudar_com_MDN
/pt-BR/docs/Projeto:Como_ajudar_com_MDN-redirect-2	/pt-BR/docs/Projeto:Como_ajudar_com_MDN
/pt-BR/docs/Quirks_Mode_and_Standards_Mode	/pt-BR/docs/Web/HTML/Quirks_Mode_and_Standards_Mode
/pt-BR/docs/Referencia_XUL	/pt-BR/docs/XUL_Reference
/pt-BR/docs/Resolucao_de_Problemas	/pt-BR/Firefox_OS/Correções
/pt-BR/docs/SVG	/pt-BR/docs/Web/SVG
/pt-BR/docs/SVG/Element	/pt-BR/docs/Web/SVG/Element
/pt-BR/docs/SVG/Element/desc	/pt-BR/docs/Web/SVG/Element/desc
/pt-BR/docs/SVG/Element/svg	/pt-BR/docs/Web/SVG/Element/svg
/pt-BR/docs/SVG/Element/texto	/pt-BR/docs/Web/SVG/Element/texto
/pt-BR/docs/Security/CSP/Utilizando_Politicas_De_Seguranca_De_Conteudo	/pt-BR/docs/Web/HTTP/CSP
/pt-BR/docs/Seções_e_estrutura_HTML5	/pt-BR/docs/Sections_and_Outlines_of_an_HTML5_document
/pt-BR/docs/Simples_Thunderbird_build	/pt-BR/docs/Mozilla/Developer_guide/Intrucoes_Build/Simples_Thunderbird_build
/pt-BR/docs/Tools/Simulador_Firefox_OS	/pt-BR/docs/Archive/B2G_OS/Simulator
/pt-BR/docs/Using_HTML5_audio_and_video	/pt-BR/docs/Web/HTML/Using_HTML5_audio_and_video
/pt-BR/docs/Using_files_from_web_applications	/pt-BR/docs/Web/API/File/Using_files_from_web_applications
/pt-BR/docs/Utilizando_áudio_e_vídeo_com_HTML5	/pt-BR/docs/Using_HTML5_audio_and_video
/pt-BR/docs/Visualizing_Audio_Spectrum	/pt-BR/docs/Archive/Misc_top_level/Visualizing_Audio_Spectrum
/pt-BR/docs/Web/API/ArrayBuffer	/pt-BR/docs/Web/JavaScript/Reference/Global_Objects/ArrayBuffer
/pt-BR/docs/Web/API/BatteryManager.charging	/pt-BR/docs/Web/API/BatteryManager/charging
/pt-BR/docs/Web/API/BatteryManager.chargingTime	/pt-BR/docs/Web/API/BatteryManager/chargingTime
/pt-BR/docs/Web/API/BatteryManager.dischargingTime	/pt-BR/docs/Web/API/BatteryManager/dischargingTime
/pt-BR/docs/Web/API/BatteryManager.level	/pt-BR/docs/Web/API/BatteryManager/level
/pt-BR/docs/Web/API/BatteryManager.onchargingchange	/pt-BR/docs/Web/API/BatteryManager/onchargingchange
/pt-BR/docs/Web/API/BatteryManager.onchargingtimechange	/pt-BR/docs/Web/API/BatteryManager/onchargingtimechange
/pt-BR/docs/Web/API/BatteryManager.ondischargingtimechange	/pt-BR/docs/Web/API/BatteryManager/ondischargintimechange
/pt-BR/docs/Web/API/BatteryManager.onlevelchange	/pt-BR/docs/Web/API/BatteryManager/onlevelchange
/pt-BR/docs/Web/API/Console.timeEnd	/pt-BR/docs/Web/API/Console/timeEnd
/pt-BR/docs/Web/API/Coordinates	/pt-BR/docs/Web/API/GeolocationCoordinates
/pt-BR/docs/Web/API/Coordinates/altitude	/pt-BR/docs/Web/API/GeolocationCoordinates/altitude
/pt-BR/docs/Web/API/Document.querySelector	/pt-BR/docs/Web/API/Document/querySelector
/pt-BR/docs/Web/API/Document.querySelectorAll	/pt-BR/docs/Web/API/Document/querySelectorAll
/pt-BR/docs/Web/API/Document/async	/pt-BR/docs/Web/API/XMLDocument/async
/pt-BR/docs/Web/API/Document/defaultView/popstate_event	/pt-BR/docs/Web/API/Window/popstate_event
/pt-BR/docs/Web/API/Document/defaultView/resize_event	/pt-BR/docs/Web/API/Window/resize_event
/pt-BR/docs/Web/API/DocumentoXML	/pt-BR/docs/Web/API/XMLDocument
/pt-BR/docs/Web/API/Element.addEventListener	/pt-BR/docs/Web/API/Element/addEventListener
/pt-BR/docs/Web/API/Element.getAttribute	/pt-BR/docs/Web/API/Element/getAttribute
/pt-BR/docs/Web/API/Element.id	/pt-BR/docs/Web/API/Element/id
/pt-BR/docs/Web/API/Element.querySelector	/pt-BR/docs/Web/API/Element/querySelector
/pt-BR/docs/Web/API/Element.querySelectorAll	/pt-BR/docs/Web/API/Element/querySelectorAll
/pt-BR/docs/Web/API/Element.removeAttribute	/pt-BR/docs/Web/API/Element/removeAttribute
/pt-BR/docs/Web/API/MozAlarmsManager	/pt-BR/docs/Archive/B2G_OS/API/MozAlarmsManager
/pt-BR/docs/Web/API/MozAlarmsManager.getAll	/pt-BR/docs/Archive/B2G_OS/API/MozAlarmsManager/MozAlarmsManager.getAll
/pt-BR/docs/Web/API/Navigator.battery	/pt-BR/docs/Web/API/Navigator/battery
/pt-BR/docs/Web/API/Navigator.mozApps	/pt-BR/docs/Web/API/Navigator/mozApps
/pt-BR/docs/Web/API/Navigator/mozApps	/pt-BR/docs/Archive/B2G_OS/API/Navigator/mozApps
/pt-BR/docs/Web/API/NavigatorID.platform	/pt-BR/docs/Web/API/NavigatorID/platform
/pt-BR/docs/Web/API/Node.appendChild	/pt-BR/docs/Web/API/Node/appendChild
/pt-BR/docs/Web/API/Node.childNodes	/pt-BR/docs/Web/API/Node/childNodes
/pt-BR/docs/Web/API/Node.contains	/pt-BR/docs/Web/API/Node/contains
/pt-BR/docs/Web/API/Node.insertBefore	/pt-BR/docs/Web/API/Node/insertBefore
/pt-BR/docs/Web/API/Node.nextSibling	/pt-BR/docs/Web/API/Node/nextSibling
/pt-BR/docs/Web/API/Node.previousSibling	/pt-BR/docs/Web/API/Node/previousSibling
/pt-BR/docs/Web/API/Node.removeChild	/pt-BR/docs/Web/API/Node/removeChild
/pt-BR/docs/Web/API/Node.replaceChild	/pt-BR/docs/Web/API/Node/replaceChild
/pt-BR/docs/Web/API/Position	/pt-BR/docs/Web/API/GeolocationPosition
/pt-BR/docs/Web/API/Position/coords	/pt-BR/docs/Web/API/GeolocationPosition/coords
/pt-BR/docs/Web/API/PositionError	/pt-BR/docs/Web/API/GeolocationPositionError
/pt-BR/docs/Web/API/URL.createObjectURL	/pt-BR/docs/Web/API/URL/createObjectURl
/pt-BR/docs/Web/API/WebGL_API/Criando_objetos_em_3D_usando_o_WebGL	/pt-BR/docs/Web/API/WebGL_API/Tutorial/Criando_objetos_em_3D_usando_o_WebGL
/pt-BR/docs/Web/API/Window.alert	/pt-BR/docs/Web/API/Window/alert
/pt-BR/docs/Web/API/Window.navigator	/pt-BR/docs/Web/API/Window/navigator
/pt-BR/docs/Web/API/Window.onscroll	/pt-BR/docs/Web/API/Window/onscroll
/pt-BR/docs/Web/API/Window.openDialog	/pt-BR/docs/Web/API/Window/openDialog
/pt-BR/docs/Web/API/WindowTimers.clearTimeout	/pt-BR/docs/Web/API/WindowTimers/clearTimeout
/pt-BR/docs/Web/API/document.getElementById	/pt-BR/docs/Web/API/Document/getElementById
/pt-BR/docs/Web/API/document.images	/pt-BR/docs/Web/API/Document/images
/pt-BR/docs/Web/API/document.scripts	/pt-BR/docs/Web/API/Document/scripts
/pt-BR/docs/Web/API/document.writeln	/pt-BR/docs/Web/API/Document/writeln
/pt-BR/docs/Web/API/event.type	/pt-BR/docs/Web/API/Event/type
/pt-BR/docs/Web/Apps/Progressive	/pt-BR/docs/Web/Progressive_web_apps
/pt-BR/docs/Web/Apps/Progressive/Introdução	/pt-BR/docs/Web/Progressive_web_apps/Introdu%C3%A7%C3%A3o
/pt-BR/docs/Web/Apps/Quickstart/Build	/pt-BR/docs/Archive/B2G_OS/Quickstart
/pt-BR/docs/Web/Apps/Quickstart/Build/For_Web_developers	/pt-BR/docs/Archive/B2G_OS/Quickstart/For_Web_developers
/pt-BR/docs/Web/Apps/Quickstart/Build/Intro_to_open_web_apps	/pt-BR/docs/Archive/B2G_OS/Quickstart/Intro_to_open_web_apps
/pt-BR/docs/Web/Apps/Quickstart/Build/meu_primeiro_app	/pt-BR/docs/Archive/B2G_OS/Quickstart/meu_primeiro_app
/pt-BR/docs/Web/CSS/CSS3	/pt-BR/docs/Archive/CSS3
/pt-BR/docs/Web/CSS/CSS_Colors	/pt-BR/docs/Web/CSS/CSS_Color
/pt-BR/docs/Web/CSS/CSS_Reference/mix-blend-mode	/pt-BR/docs/Web/CSS/mix-blend-mode
/pt-BR/docs/Web/CSS/Child_selectors	/pt-BR/docs/Web/CSS/Child_combinator
/pt-BR/docs/Web/CSS/General_sibling_selectors	/pt-BR/docs/Web/CSS/General_sibling_combinator
/pt-BR/docs/Web/CSS/Using_CSS_variables	/pt-BR/docs/Web/CSS/Using_CSS_custom_properties
/pt-BR/docs/Web/CSS/máscara	/pt-BR/docs/mask
/pt-BR/docs/Web/Events/click	/pt-BR/docs/Web/API/Element/click_event
/pt-BR/docs/Web/Events/keydown	/pt-BR/docs/Web/API/Document/keydown_event
/pt-BR/docs/Web/Events/keypress	/pt-BR/docs/Web/API/Document/keypress_event
/pt-BR/docs/Web/Events/keyup	/pt-BR/docs/Web/API/Document/keyup_event
/pt-BR/docs/Web/Events/mousedown	/pt-BR/docs/Web/API/Element/mousedown_event
/pt-BR/docs/Web/Events/mouseenter	/pt-BR/docs/Web/API/Element/mouseenter_event
/pt-BR/docs/Web/Events/mouseover	/pt-BR/docs/Web/API/Element/mouseover_event
/pt-BR/docs/Web/Events/popstate	/pt-BR/docs/Web/API/Document/defaultView/popstate_event
/pt-BR/docs/Web/Events/resize	/pt-BR/docs/Web/API/Document/defaultView/resize_event
/pt-BR/docs/Web/Events/scroll	/pt-BR/docs/Web/API/Document/scroll_event
/pt-BR/docs/Web/Events/touchstart	/pt-BR/docs/Web/API/Element/touchstart_event
/pt-BR/docs/Web/Guide/API/Telephony	/pt-BR/docs/Archive/B2G_OS/Web_Telephony_API
/pt-BR/docs/Web/Guide/CSS	/pt-BR/docs/Learn/CSS
/pt-BR/docs/Web/Guide/HTML	/pt-BR/docs/Learn/HTML
/pt-BR/docs/Web/HTML/Element/<b>	/pt-BR/docs/Web/HTML/Element/b
/pt-BR/docs/Web/HTML/HTML5/HTML5_element_list	/pt-BR/docs/Web/HTML/Element
/pt-BR/docs/Web/HTTP/Cabecalhos_HTTP	/pt-BR/docs/Web/HTTP/Headers
/pt-BR/docs/Web/HTTP/Headers/Expira	/pt-BR/docs/Web/HTTP/Headers/Expires
/pt-BR/docs/Web/JavaScript/Guide/About	/pt-BR/docs/Web/JavaScript/Guide/Introduction
/pt-BR/docs/Web/JavaScript/Guide/Inheritance_Revisited	/pt-BR/docs/Web/JavaScript/Guide/Inheritance_and_the_prototype_chain
/pt-BR/docs/Web/JavaScript/Guide/JavaScript_Visão_Geral	/pt-BR/docs/Web/JavaScript/Guide/Introduction
/pt-BR/docs/Web/JavaScript/New_in_JavaScript/Suporte_ao_ECMAScript_7_no_Mozilla	/pt-BR/docs/Archive/Web/JavaScript/Suporte_ao_ECMAScript_7_no_Mozilla
/pt-BR/docs/Web/JavaScript/Outras_ferramentas_JavaScript	/pt-BR/docs/Tools
/pt-BR/docs/Web/SVG/Element/texto	/pt-BR/docs/Web/SVG/Element/text
/pt-BR/docs/Web/WebGL	/pt-BR/docs/Web/API/WebGL_API
/pt-BR/docs/Web/WebGL/Criando_objetos_em_3D_usando_o_WebGL	/pt-BR/docs/Web/API/WebGL_API/Criando_objetos_em_3D_usando_o_WebGL
/pt-BR/docs/WebAPI/Alarme	/pt-BR/docs/Archive/B2G_OS/API/Alarm_API
/pt-BR/docs/WebAPI/WebBluetooth	/pt-BR/docs/Archive/B2G_OS/Bluetooth_API
/pt-BR/docs/WebGL	/pt-BR/docs/Web/WebGL
/pt-BR/docs/WebRTC/navigator.getUserMedia	/pt-BR/docs/Web/API/Navigator/getUserMedia
/pt-BR/docs/XUL	/pt-BR/docs/Mozilla/Tech/XUL
/pt-BR/docs/XUL/Overlays	/pt-BR/docs/Mozilla/Tech/XUL/Overlays
/pt-BR/docs/XULRunner	/pt-BR/docs/Archive/Mozilla/XULRunner
/pt-BR/docs/XUL_Reference	/pt-BR/docs/Mozilla/Tech/XUL/XUL_Reference
/pt-BR/docs/adentrando_a_tabela_html_com_JavaScript_e_interfaces_DOM	/pt-BR/docs/Traversing_an_HTML_table_with_JavaScript_and_DOM_Interfaces
/pt-BR/docs/c_temp	/pt-BR/docs/Web/API/Console
/pt-BR/docs/en	/
/pt-BR/docs/persona/Browser_compatibility	/pt-BR/docs/Mozilla/Persona/Browser_compatibility
