# FROM-URL	TO-URL
/pt-PT/docs/AJAX	/pt-PT/docs/Web/Guide/AJAX
/pt-PT/docs/AJAX/Como_começar	/pt-PT/docs/Web/Guide/AJAX/Como_come%C3%A7ar
/pt-PT/docs/AJAX:Como_começar	/docs/pt/AJAX/Como_come%C3%A7ar
/pt-PT/docs/AJAX:Comunidade	/docs/pt/AJAX/Comunidade
/pt-PT/docs/AJAX:Outros_recursos	/docs/pt/AJAX/Outros_recursos
/pt-PT/docs/Acessibilidade	/pt-PT/docs/Web/Acessibilidade
/pt-PT/docs/Archive/B2G_OS/Developer_phone_guide	/pt-PT/docs/Archive/B2G_OS/Phone_guide
/pt-PT/docs/Archive/B2G_OS/Developer_phone_guide/Flame	/pt-PT/docs/Archive/B2G_OS/Phone_guide/Flame
/pt-PT/docs/Archive/Firefox_OS/Firefox_OS_apps/Localização	/pt-PT/docs/Archive/B2G_OS/Firefox_OS_apps/Localiza%C3%A7%C3%A3o
/pt-PT/docs/Archive/Plugins/Out_of_process_plugins	/en-US/docs/Multi-Process_Architecture
/pt-PT/docs/CSS	/pt-PT/docs/Web/CSS
/pt-PT/docs/CSS/:after	/pt-PT/docs/Web/CSS/:after
/pt-PT/docs/CSS/:before	/pt-PT/docs/Web/CSS/:before
/pt-PT/docs/CSS/@font-face	/pt-PT/docs/Web/CSS/@font-face
/pt-PT/docs/CSS/@import	/pt-PT/docs/Web/CSS/@import
/pt-PT/docs/CSS/@media	/pt-PT/docs/Web/CSS/@media
/pt-PT/docs/CSS/Como_começar	/pt-PT/docs/Web/CSS/Como_come%C3%A7ar
/pt-PT/docs/CSS/Como_começar/CSS_legível	/pt-PT/docs/Web/CSS/Como_come%C3%A7ar/CSS_leg%C3%ADvel
/pt-PT/docs/CSS/Como_começar/Caixas	/pt-PT/docs/Web/CSS/Como_come%C3%A7ar/Caixas
/pt-PT/docs/CSS/Como_começar/Cascata_e_herança	/pt-PT/docs/Web/CSS/Como_come%C3%A7ar/Cascata_e_heran%C3%A7a
/pt-PT/docs/CSS/Como_começar/Como_o_CSS_trabalha	/pt-PT/docs/Web/CSS/Como_come%C3%A7ar/Como_o_CSS_trabalha
/pt-PT/docs/CSS/Como_começar/Conteúdo	/pt-PT/docs/Web/CSS/Como_come%C3%A7ar/Conte%C3%BAdo
/pt-PT/docs/CSS/Como_começar/Cor	/pt-PT/docs/Web/CSS/Como_come%C3%A7ar/Cor
/pt-PT/docs/CSS/Como_começar/Dados_XML	/pt-PT/docs/Web/CSS/Como_come%C3%A7ar/Dados_XML
/pt-PT/docs/CSS/Como_começar/Disposição	/pt-PT/docs/Web/CSS/Como_come%C3%A7ar/Disposi%C3%A7%C3%A3o
/pt-PT/docs/CSS/Como_começar/Estilos_de_texto	/pt-PT/docs/Web/CSS/Como_come%C3%A7ar/Estilos_de_texto
/pt-PT/docs/CSS/Como_começar/Gráficos_SVG	/pt-PT/docs/Web/CSS/Como_come%C3%A7ar/Gr%C3%A1ficos_SVG
/pt-PT/docs/CSS/Como_começar/Interfaces_de_usuário_XUL	/pt-PT/docs/Web/CSS/Como_come%C3%A7ar/Interfaces_de_usu%C3%A1rio_XUL
/pt-PT/docs/CSS/Como_começar/JavaScript	/pt-PT/docs/CSS/Getting_Started/JavaScript
/pt-PT/docs/CSS/Como_começar/Listas	/pt-PT/docs/Web/CSS/Como_come%C3%A7ar/Listas
/pt-PT/docs/CSS/Como_começar/Mídia	/pt-PT/docs/Web/CSS/Como_come%C3%A7ar/M%C3%ADdia
/pt-PT/docs/CSS/Como_começar/O_que_é_CSS	/pt-PT/docs/Web/CSS/Como_come%C3%A7ar/O_que_%C3%A9_CSS
/pt-PT/docs/CSS/Como_começar/O_que_é_CSS?	/pt-PT/docs/Web/CSS/Como_come%C3%A7ar/O_que_%C3%A9_CSS?
/pt-PT/docs/CSS/Como_começar/Porque_usar_CSS	/pt-PT/docs/Web/CSS/Como_come%C3%A7ar/Porque_usar_CSS
/pt-PT/docs/CSS/Como_começar/Seletores	/pt-PT/docs/Web/CSS/Como_come%C3%A7ar/Seletores
/pt-PT/docs/CSS/Como_começar/Tabelas	/pt-PT/docs/Web/CSS/Como_come%C3%A7ar/Tabelas
/pt-PT/docs/CSS/Como_começar/XBL_bindings	/pt-PT/docs/Web/CSS/Como_come%C3%A7ar/XBL_bindings
/pt-PT/docs/CSS/Consulta_de_mídia	/pt-PT/docs/Web/CSS/Consulta_de_m%C3%ADdia
/pt-PT/docs/CSS/Getting_Started/JavaScript	/pt-PT/docs/Web/CSS/Como_come%C3%A7ar/JavaScript
/pt-PT/docs/CSS/Múltiplos_fundos	/pt-PT/docs/Web/CSS/M%C3%BAltiplos_fundos
/pt-PT/docs/CSS/Múltiplos_planos_de_fundo	/pt-PT/docs/Web/CSS/M%C3%BAltiplos_planos_de_fundo
/pt-PT/docs/CSS/Usando_transformações_CSS	/pt-PT/docs/Web/CSS/Usando_transforma%C3%A7%C3%B5es_CSS
/pt-PT/docs/CSS/azimuth	/pt-PT/docs/Web/CSS/azimuth
/pt-PT/docs/CSS/background	/pt-PT/docs/Web/CSS/background
/pt-PT/docs/CSS/background-attachment	/pt-PT/docs/Web/CSS/background-attachment
/pt-PT/docs/CSS/background-color	/pt-PT/docs/Web/CSS/background-color
/pt-PT/docs/CSS/background-image	/pt-PT/docs/Web/CSS/background-image
/pt-PT/docs/CSS/background-position	/pt-PT/docs/Web/CSS/background-position
/pt-PT/docs/CSS/background-repeat	/pt-PT/docs/Web/CSS/background-repeat
/pt-PT/docs/CSS/border	/pt-PT/docs/Web/CSS/border
/pt-PT/docs/CSS/border-bottom	/pt-PT/docs/Web/CSS/border-bottom
/pt-PT/docs/CSS/border-bottom-color	/pt-PT/docs/Web/CSS/border-bottom-color
/pt-PT/docs/CSS/border-bottom-style	/pt-PT/docs/Web/CSS/border-bottom-style
/pt-PT/docs/CSS/border-bottom-width	/pt-PT/docs/Web/CSS/border-bottom-width
/pt-PT/docs/CSS/border-collapse	/pt-PT/docs/Web/CSS/border-collapse
/pt-PT/docs/CSS/border-color	/pt-PT/docs/Web/CSS/border-color
/pt-PT/docs/CSS/border-left	/pt-PT/docs/Web/CSS/border-left
/pt-PT/docs/CSS/border-left-color	/pt-PT/docs/Web/CSS/border-left-color
/pt-PT/docs/CSS/border-left-style	/pt-PT/docs/Web/CSS/border-left-style
/pt-PT/docs/CSS/border-left-width	/pt-PT/docs/Web/CSS/border-left-width
/pt-PT/docs/CSS/border-right	/pt-PT/docs/Web/CSS/border-right
/pt-PT/docs/CSS/border-right-color	/pt-PT/docs/Web/CSS/border-right-color
/pt-PT/docs/CSS/border-right-style	/pt-PT/docs/Web/CSS/border-right-style
/pt-PT/docs/CSS/border-right-width	/pt-PT/docs/Web/CSS/border-right-width
/pt-PT/docs/CSS/border-spacing	/pt-PT/docs/Web/CSS/border-spacing
/pt-PT/docs/CSS/border-style	/pt-PT/docs/Web/CSS/border-style
/pt-PT/docs/CSS/border-top	/pt-PT/docs/Web/CSS/border-top
/pt-PT/docs/CSS/border-top-color	/pt-PT/docs/Web/CSS/border-top-color
/pt-PT/docs/CSS/border-top-style	/pt-PT/docs/Web/CSS/border-top-style
/pt-PT/docs/CSS/border-top-width	/pt-PT/docs/Web/CSS/border-top-width
/pt-PT/docs/CSS/border-width	/pt-PT/docs/Web/CSS/border-width
/pt-PT/docs/CSS/bottom	/pt-PT/docs/Web/CSS/bottom
/pt-PT/docs/CSS/clear	/pt-PT/docs/Web/CSS/clear
/pt-PT/docs/CSS/color	/pt-PT/docs/Web/CSS/color
/pt-PT/docs/CSS/content	/pt-PT/docs/Web/CSS/content
/pt-PT/docs/CSS/counter-increment	/pt-PT/docs/Web/CSS/counter-increment
/pt-PT/docs/CSS/counter-reset	/pt-PT/docs/Web/CSS/counter-reset
/pt-PT/docs/CSS/cursor	/pt-PT/docs/Web/CSS/cursor
/pt-PT/docs/CSS/direction	/pt-PT/docs/Web/CSS/direction
/pt-PT/docs/CSS/display	/pt-PT/docs/Web/CSS/display
/pt-PT/docs/CSS/float	/pt-PT/docs/Web/CSS/float
/pt-PT/docs/CSS/font	/pt-PT/docs/Web/CSS/font
/pt-PT/docs/CSS/font-family	/pt-PT/docs/Web/CSS/font-family
/pt-PT/docs/CSS/font-size	/pt-PT/docs/Web/CSS/font-size
/pt-PT/docs/CSS/font-size-adjust	/pt-PT/docs/Web/CSS/font-size-adjust
/pt-PT/docs/CSS/font-style	/pt-PT/docs/Web/CSS/font-style
/pt-PT/docs/CSS/font-weight	/pt-PT/docs/Web/CSS/font-weight
/pt-PT/docs/CSS/height	/pt-PT/docs/Web/CSS/height
/pt-PT/docs/CSS/inherit	/pt-PT/docs/Web/CSS/inherit
/pt-PT/docs/CSS/list-style	/pt-PT/docs/Web/CSS/list-style
/pt-PT/docs/CSS/top	/pt-PT/docs/Web/CSS/top
/pt-PT/docs/CSS/width	/pt-PT/docs/Web/CSS/width
/pt-PT/docs/CSS/z-index	/pt-PT/docs/Web/CSS/z-index
/pt-PT/docs/CSS::after	/docs/pt/CSS/:after
/pt-PT/docs/CSS::before	/docs/pt/CSS/:before
/pt-PT/docs/CSS:@import	/docs/pt/CSS/@import
/pt-PT/docs/CSS:@media	/docs/pt/CSS/@media
/pt-PT/docs/CSS:Como_começar	/docs/pt/CSS/Como_come%C3%A7ar
/pt-PT/docs/CSS:Como_começar:CSS_legível	/docs/pt/CSS/Como_come%C3%A7ar/CSS_leg%C3%ADvel
/pt-PT/docs/CSS:Como_começar:Caixas	/docs/pt/CSS/Como_come%C3%A7ar/Caixas
/pt-PT/docs/CSS:Como_começar:Cascata_e_herança	/docs/pt/CSS/Como_come%C3%A7ar/Cascata_e_heran%C3%A7a
/pt-PT/docs/CSS:Como_começar:Como_o_CSS_trabalha	/docs/pt/CSS/Como_come%C3%A7ar/Como_o_CSS_trabalha
/pt-PT/docs/CSS:Como_começar:Conteúdo	/docs/pt/CSS/Como_come%C3%A7ar/Conte%C3%BAdo
/pt-PT/docs/CSS:Como_começar:Cor	/docs/pt/CSS/Como_come%C3%A7ar/Cor
/pt-PT/docs/CSS:Como_começar:Dados_XML	/docs/pt/CSS/Como_come%C3%A7ar/Dados_XML
/pt-PT/docs/CSS:Como_começar:Disposição	/docs/pt/CSS/Como_come%C3%A7ar/Disposi%C3%A7%C3%A3o
/pt-PT/docs/CSS:Como_começar:Estilos_de_texto	/docs/pt/CSS/Como_come%C3%A7ar/Estilos_de_texto
/pt-PT/docs/CSS:Como_começar:Gráficos_SVG	/docs/pt/CSS/Como_come%C3%A7ar/Gr%C3%A1ficos_SVG
/pt-PT/docs/CSS:Como_começar:Interfaces_de_usuário_XUL	/docs/pt/CSS/Como_come%C3%A7ar/Interfaces_de_usu%C3%A1rio_XUL
/pt-PT/docs/CSS:Como_começar:JavaScript	/docs/pt/CSS/Como_come%C3%A7ar/JavaScript
/pt-PT/docs/CSS:Como_começar:Listas	/docs/pt/CSS/Como_come%C3%A7ar/Listas
/pt-PT/docs/CSS:Como_começar:Mídia	/docs/pt/CSS/Como_come%C3%A7ar/M%C3%ADdia
/pt-PT/docs/CSS:Como_começar:O_que_é_CSS	/docs/pt/CSS/Como_come%C3%A7ar/O_que_%C3%A9_CSS
/pt-PT/docs/CSS:Como_começar:O_que_é_CSS?	/docs/pt/CSS/Como_come%C3%A7ar/O_que_%C3%A9_CSS?
/pt-PT/docs/CSS:Como_começar:Porque_usar_CSS	/docs/pt/CSS/Como_come%C3%A7ar/Porque_usar_CSS
/pt-PT/docs/CSS:Como_começar:Seletores	/docs/pt/CSS/Como_come%C3%A7ar/Seletores
/pt-PT/docs/CSS:Como_começar:Tabelas	/docs/pt/CSS/Como_come%C3%A7ar/Tabelas
/pt-PT/docs/CSS:Como_começar:XBL_bindings	/docs/pt/CSS/Como_come%C3%A7ar/XBL_bindings
/pt-PT/docs/CSS:Comunidade	/docs/pt/CSS/Comunidade
/pt-PT/docs/CSS:Outros_recursos	/docs/pt/CSS/Outros_recursos
/pt-PT/docs/CSS:azimuth	/docs/pt/CSS/azimuth
/pt-PT/docs/CSS:background	/docs/pt/CSS/background
/pt-PT/docs/CSS:background-attachment	/docs/pt/CSS/background-attachment
/pt-PT/docs/CSS:background-color	/docs/pt/CSS/background-color
/pt-PT/docs/CSS:background-image	/docs/pt/CSS/background-image
/pt-PT/docs/CSS:background-position	/docs/pt/CSS/background-position
/pt-PT/docs/CSS:background-repeat	/docs/pt/CSS/background-repeat
/pt-PT/docs/CSS:border	/docs/pt/CSS/border
/pt-PT/docs/CSS:border-bottom	/docs/pt/CSS/border-bottom
/pt-PT/docs/CSS:border-bottom-color	/docs/pt/CSS/border-bottom-color
/pt-PT/docs/CSS:border-bottom-style	/docs/pt/CSS/border-bottom-style
/pt-PT/docs/CSS:border-bottom-width	/docs/pt/CSS/border-bottom-width
/pt-PT/docs/CSS:border-collapse	/docs/pt/CSS/border-collapse
/pt-PT/docs/CSS:border-color	/docs/pt/CSS/border-color
/pt-PT/docs/CSS:border-left	/docs/pt/CSS/border-left
/pt-PT/docs/CSS:border-left-color	/docs/pt/CSS/border-left-color
/pt-PT/docs/CSS:border-left-style	/docs/pt/CSS/border-left-style
/pt-PT/docs/CSS:border-left-width	/docs/pt/CSS/border-left-width
/pt-PT/docs/CSS:border-right	/docs/pt/CSS/border-right
/pt-PT/docs/CSS:border-right-color	/docs/pt/CSS/border-right-color
/pt-PT/docs/CSS:border-right-style	/docs/pt/CSS/border-right-style
/pt-PT/docs/CSS:border-right-width	/docs/pt/CSS/border-right-width
/pt-PT/docs/CSS:border-spacing	/docs/pt/CSS/border-spacing
/pt-PT/docs/CSS:border-style	/docs/pt/CSS/border-style
/pt-PT/docs/CSS:border-top	/docs/pt/CSS/border-top
/pt-PT/docs/CSS:border-top-color	/docs/pt/CSS/border-top-color
/pt-PT/docs/CSS:border-top-style	/docs/pt/CSS/border-top-style
/pt-PT/docs/CSS:border-top-width	/docs/pt/CSS/border-top-width
/pt-PT/docs/CSS:border-width	/docs/pt/CSS/border-width
/pt-PT/docs/CSS:bottom	/docs/pt/CSS/bottom
/pt-PT/docs/CSS:clear	/docs/pt/CSS/clear
/pt-PT/docs/CSS:color	/docs/pt/CSS/color
/pt-PT/docs/CSS:counter-increment	/docs/pt/CSS/counter-increment
/pt-PT/docs/CSS:counter-reset	/docs/pt/CSS/counter-reset
/pt-PT/docs/CSS:cursor	/docs/pt/CSS/cursor
/pt-PT/docs/CSS:direction	/docs/pt/CSS/direction
/pt-PT/docs/CSS:display	/docs/pt/CSS/display
/pt-PT/docs/CSS:float	/docs/pt/CSS/float
/pt-PT/docs/CSS:font	/docs/pt/CSS/font
/pt-PT/docs/CSS:font-family	/docs/pt/CSS/font-family
/pt-PT/docs/CSS:font-size	/docs/pt/CSS/font-size
/pt-PT/docs/CSS:font-size-adjust	/docs/pt/CSS/font-size-adjust
/pt-PT/docs/CSS:font-style	/docs/pt/CSS/font-style
/pt-PT/docs/CSS:font-weight	/docs/pt/CSS/font-weight
/pt-PT/docs/CSS:height	/docs/pt/CSS/height
/pt-PT/docs/CSS:inherit	/docs/pt/CSS/inherit
/pt-PT/docs/CSS:list-style	/docs/pt/CSS/list-style
/pt-PT/docs/CSS:width	/docs/pt/CSS/width
/pt-PT/docs/CSS:z-index	/docs/pt/CSS/z-index
/pt-PT/docs/CSS_Reference:Property_Template	/docs/pt/CSS_Reference/Property_Template
/pt-PT/docs/Communication_between_HTML_and_your_extension	/pt-PT/docs/Archive/Add-ons/Communication_between_HTML_and_your_extension
/pt-PT/docs/Compressão_de_Temas	/docs/pt/Empacotando_Temas
/pt-PT/docs/Controles_Customizados	/docs/pt/XForms/Controles_Customizados
/pt-PT/docs/Criando_um_visual_para_o_Firefox:Iniciando	/docs/pt/Criando_um_visual_para_o_Firefox/Iniciando
/pt-PT/docs/Criando_um_visual_para_o_Firefox:UUID	/docs/pt/Criando_um_visual_para_o_Firefox/UUID
/pt-PT/docs/Criando_um_visual_para_o_Firefox:contents.rdf	/docs/pt/Criando_um_visual_para_o_Firefox/contents.rdf
/pt-PT/docs/Criando_um_visual_para_o_Firefox:install.rdf	/docs/pt/Criando_um_visual_para_o_Firefox/install.rdf
/pt-PT/docs/DOM	/pt-PT/docs/DOM/DOM_Reference
/pt-PT/docs/DOM/DOM_Storage	/docs/Pt/DOM/Storage
/pt-PT/docs/DOM:Comunidade	/docs/pt/DOM/Comunidade
/pt-PT/docs/DOM:Outros_recursos	/docs/pt/DOM/Outros_recursos
/pt-PT/docs/DOM:WRONG_DOCUMENT_ERR_note	/docs/pt/DOM/WRONG_DOCUMENT_ERR_note
/pt-PT/docs/DOM:document.getElementsByClassName	/docs/pt/DOM/document.getElementsByClassName
/pt-PT/docs/DOM:element	/docs/pt/DOM/element
/pt-PT/docs/DOM:element.appendChild	/docs/pt/DOM/element.appendChild
/pt-PT/docs/DOM:element.clientLeft	/docs/pt/DOM/element.clientLeft
/pt-PT/docs/DOM:element.clientTop	/docs/pt/DOM/element.clientTop
/pt-PT/docs/DOM:element.cloneNode	/docs/pt/DOM/element.cloneNode
/pt-PT/docs/DOM:element.insertBefore	/docs/pt/DOM/element.insertBefore
/pt-PT/docs/DOM:window.navigator.registerProtocolHandler	/docs/pt/DOM/window.navigator.registerProtocolHandler
/pt-PT/docs/Desenvolver_Mozilla	/docs/pt/Desenvolvimento_Mozilla
/pt-PT/docs/Desenvolvimento_Mozilla	/pt-PT/docs/Guia_do_desenvolvedor
/pt-PT/docs/Desenvolvimento_Web	/pt-PT/docs/Web/Guide
/pt-PT/docs/Embeber_Mozilla	/docs/pt/Embutindo_o_Mozilla
/pt-PT/docs/Embutindo_o_Mozilla	/pt-PT/docs/Gecko/Embedding_Mozilla
/pt-PT/docs/Embutir_Mozilla	/docs/pt/Embutindo_o_Mozilla
/pt-PT/docs/Eventos_online_e_offline	/pt-PT/docs/Web/API/NavigatorOnLine/Eventos_online_e_offline
/pt-PT/docs/Extensões	/pt-PT/Add-ons
/pt-PT/docs/Extensões:Comunidade	/docs/pt/Extens%C3%B5es/Comunidade
/pt-PT/docs/Folhas_de_estilo_alternativas	/pt-PT/docs/Web/CSS/Folhas_de_estilo_alternativas
/pt-PT/docs/GQ	/pt-PT/docs/QA
/pt-PT/docs/GQ:Artigos	/docs/pt/GQ/Artigos
/pt-PT/docs/GQ:Referências	/docs/pt/GQ/Refer%C3%AAncias
/pt-PT/docs/Gecko_DOM_Reference	/docs/pt/Refer%C3%AAncia_do_DOM_Gecko
/pt-PT/docs/Gecko_DOM_Reference/Preface	/docs/pt/Refer%C3%AAncia_do_DOM_Gecko/Pref%C3%A1cio
/pt-PT/docs/Gecko_DOM_Reference:Introduction	/docs/pt/Gecko_DOM_Reference/Introduction
/pt-PT/docs/Gecko_DOM_Reference:Preface	/docs/pt/Gecko_DOM_Reference/Preface
/pt-PT/docs/HTML	/pt-PT/docs/Web/HTML
/pt-PT/docs/HTML/Aplicar_cor__elementos_HTML_utilizando_CSS	/pt-PT/docs/Web/HTML/Aplicar_cor_elementos_HTML_utilizando_CSS
/pt-PT/docs/HTML/Atributos	/pt-PT/docs/Web/HTML/Atributos
/pt-PT/docs/HTML/Atributos_globais	/pt-PT/docs/Web/HTML/Atributos_globais
/pt-PT/docs/HTML/Element	/pt-PT/docs/Web/HTML/Element
/pt-PT/docs/HTML/Element/Audio	/pt-PT/docs/Web/HTML/Element/Audio
/pt-PT/docs/HTML/Element/figcaption	/pt-PT/docs/HTML/Elemento/figcaption
/pt-PT/docs/HTML/Element/figure	/pt-PT/docs/Web/HTML/Element/figure
/pt-PT/docs/HTML/Element/progress	/pt-PT/docs/Web/HTML/Element/progress
/pt-PT/docs/HTML/Elemento	/pt-PT/docs/Web/HTML/Elemento
/pt-PT/docs/HTML/Elemento/Audio	/pt-PT/docs/Web/HTML/Elemento/Audio
/pt-PT/docs/HTML/Elemento/Video	/pt-PT/docs/Web/HTML/Elemento/Video
/pt-PT/docs/HTML/Elemento/figcaption	/pt-PT/docs/Web/HTML/Elemento/figcaption
/pt-PT/docs/HTML/Elemento/head	/pt-PT/docs/Web/HTML/Elemento/head
/pt-PT/docs/HTML/Elemento/nav	/pt-PT/docs/Web/HTML/Elemento/nav
/pt-PT/docs/HTML/Elemento/progress	/pt-PT/docs/Web/HTML/Elemento/progress
/pt-PT/docs/HTML/Elemento/progress/progress	/docs/Pt/HTML/Elemento/progress
/pt-PT/docs/HTML/HTML5	/pt-PT/docs/Web/HTML/HTML5
/pt-PT/docs/HTML/HTML5/Forms_no_HTML5	/pt-PT/docs/Web/HTML/HTML5/Forms_no_HTML5
/pt-PT/docs/HTML/HTML5/Introdução_ao_HTML5	/pt-PT/docs/Web/HTML/HTML5/Introdu%C3%A7%C3%A3o_ao_HTML5
/pt-PT/docs/HTML/HTML5/Parser_HTML5	/pt-PT/docs/Web/HTML/HTML5/Parser_HTML5
/pt-PT/docs/HTML/Referencia	/pt-PT/docs/Web/HTML/Referencia
/pt-PT/docs/HTML/Tipos_de_hiperligacao	/pt-PT/docs/Web/HTML/Tipos_de_hiperligacao
/pt-PT/docs/HTML:Comunidade	/docs/pt/HTML/Comunidade
/pt-PT/docs/HTML:Outros_recursos	/docs/pt/HTML/Outros_recursos
/pt-PT/docs/HTMLToDelete	/en-US/docs/Web/HTML
/pt-PT/docs/HTMLToDelete/Aplicar_cor__elementos_HTML_utilizando_CSS	/pt-PT/docs/HTML/Aplicar_cor__elementos_HTML_utilizando_CSS
/pt-PT/docs/HTMLToDelete/Atributos	/pt-PT/docs/HTML/Atributos
/pt-PT/docs/HTMLToDelete/Atributos_globais	/pt-PT/docs/HTML/Atributos_globais
/pt-PT/docs/HTMLToDelete/Element	/pt-PT/docs/HTML/Elemento
/pt-PT/docs/HTMLToDelete/Element/Audio	/pt-PT/docs/HTML/Elemento/Audio
/pt-PT/docs/HTMLToDelete/Element/progress	/docs/Pt/HTML/Elemento/progress
/pt-PT/docs/HTMLToDelete/Elemento	/pt-PT/docs/HTML/Elemento
/pt-PT/docs/HTMLToDelete/Elemento/Audio	/pt-PT/docs/HTML/Elemento/Audio
/pt-PT/docs/HTMLToDelete/Elemento/Video	/pt-PT/docs/HTML/Elemento/Video
/pt-PT/docs/HTMLToDelete/Elemento/figcaption	/pt-PT/docs/HTML/Elemento/figcaption
/pt-PT/docs/HTMLToDelete/Elemento/head	/pt-PT/docs/HTML/Elemento/head
/pt-PT/docs/HTMLToDelete/Elemento/nav	/pt-PT/docs/HTML/Elemento/nav
/pt-PT/docs/HTMLToDelete/Elemento/progress	/pt-PT/docs/HTML/Elemento/progress
/pt-PT/docs/HTMLToDelete/Referencia	/pt-PT/docs/HTML/Referencia
/pt-PT/docs/HTMLToDelete/Tipos_de_hiperligacao	/pt-PT/docs/HTML/Tipos_de_hiperligacao
/pt-PT/docs/Introducao_a_XML	/pt-PT/docs/Web/XML/Introducao_a_XML
/pt-PT/docs/JavaScript	/pt-PT/docs/Web/JavaScript
/pt-PT/docs/JavaScript/Guia	/pt-PT/docs/Web/JavaScript/Guia
/pt-PT/docs/JavaScript/Guia/Expressoes_e_Operadores	/pt-PT/docs/Web/JavaScript/Guia/Expressoes_e_Operadores
/pt-PT/docs/JavaScript/Guia/Introdução_ao_JavaScript	/pt-PT/docs/Web/JavaScript/Guia/Introdu%C3%A7%C3%A3o_ao_JavaScript
/pt-PT/docs/JavaScript/Guia/Sobre	/pt-PT/docs/Web/JavaScript/Guia/Sobre
/pt-PT/docs/JavaScript/Guia/Sobre_este_guia	/pt-PT/docs/Web/JavaScript/Guia/Sobre_este_guia
/pt-PT/docs/JavaScript/Guia/Valores,_Variáveis_e_Literais	/pt-PT/docs/Web/JavaScript/Guia/Valores,_Vari%C3%A1veis_e_Literais
/pt-PT/docs/JavaScript/Guia_de_JavaScript	/pt-PT/docs/Web/JavaScript/Guia_de_JavaScript
/pt-PT/docs/JavaScript/Novidades_no_JavaScript	/pt-PT/docs/Web/JavaScript/Novidades_no_JavaScript
/pt-PT/docs/JavaScript/Novidades_no_JavaScript/Novidades_no_Javascript_1.8	/pt-PT/docs/Web/JavaScript/Novidades_no_JavaScript/Novidades_no_Javascript_1.8
/pt-PT/docs/JavaScript/O_que_é_o_JavaScript	/pt-PT/docs/Web/JavaScript/O_que_%C3%A9_o_JavaScript
/pt-PT/docs/JavaScript/Referência/About	/docs/en/JavaScript/Reference/About
/pt-PT/docs/JavaScript/Referência/Code_comments	/docs/en/JavaScript/Reference/Code_comments
/pt-PT/docs/JavaScript/Referência/Deprecated_and_obsolete_features	/docs/en/JavaScript/Reference/Deprecated_and_obsolete_features
/pt-PT/docs/JavaScript/Referência/Functions_and_function_scope	/docs/en/JavaScript/Reference/Functions_and_function_scope
/pt-PT/docs/JavaScript/Referência/Functions_and_function_scope/arguments	/docs/en/JavaScript/Reference/Functions_and_function_scope/arguments
/pt-PT/docs/JavaScript/Referência/Functions_and_function_scope/arguments/callee	/docs/en/JavaScript/Reference/Functions_and_function_scope/arguments/callee
/pt-PT/docs/JavaScript/Referência/Functions_and_function_scope/arguments/caller	/docs/en/JavaScript/Reference/Functions_and_function_scope/arguments/caller
/pt-PT/docs/JavaScript/Referência/Functions_and_function_scope/arguments/length	/docs/en/JavaScript/Reference/Functions_and_function_scope/arguments/length
/pt-PT/docs/JavaScript/Referência/Global_Objects	/docs/en/JavaScript/Reference/Global_Objects
/pt-PT/docs/JavaScript/Referência/Global_Objects/Array	/docs/en/JavaScript/Reference/Global_Objects/Array
/pt-PT/docs/JavaScript/Referência/Global_Objects/Array/Reduce	/docs/en/JavaScript/Reference/Global_Objects/Array/Reduce
/pt-PT/docs/JavaScript/Referência/Global_Objects/Array/ReduceRight	/docs/en/JavaScript/Reference/Global_Objects/Array/ReduceRight
/pt-PT/docs/JavaScript/Referência/Global_Objects/Array/concat	/docs/en/JavaScript/Reference/Global_Objects/Array/concat
/pt-PT/docs/JavaScript/Referência/Global_Objects/Array/constructor	/docs/en/JavaScript/Reference/Global_Objects/Array/constructor
/pt-PT/docs/JavaScript/Referência/Global_Objects/Array/every	/docs/en/JavaScript/Reference/Global_Objects/Array/every
/pt-PT/docs/JavaScript/Referência/Global_Objects/Array/filter	/docs/en/JavaScript/Reference/Global_Objects/Array/filter
/pt-PT/docs/JavaScript/Referência/Global_Objects/Array/forEach	/docs/en/JavaScript/Reference/Global_Objects/Array/forEach
/pt-PT/docs/JavaScript/Referência/Global_Objects/Array/indexOf	/docs/en/JavaScript/Reference/Global_Objects/Array/indexOf
/pt-PT/docs/JavaScript/Referência/Global_Objects/Array/isArray	/docs/en/JavaScript/Reference/Global_Objects/Array/isArray
/pt-PT/docs/JavaScript/Referência/Global_Objects/Array/join	/docs/en/JavaScript/Reference/Global_Objects/Array/join
/pt-PT/docs/JavaScript/Referência/Global_Objects/Array/lastIndexOf	/docs/en/JavaScript/Reference/Global_Objects/Array/lastIndexOf
/pt-PT/docs/JavaScript/Referência/Global_Objects/Array/length	/docs/en/JavaScript/Reference/Global_Objects/Array/length
/pt-PT/docs/JavaScript/Referência/Global_Objects/Array/map	/docs/en/JavaScript/Reference/Global_Objects/Array/map
/pt-PT/docs/JavaScript/Referência/Global_Objects/Array/pop	/docs/en/JavaScript/Reference/Global_Objects/Array/pop
/pt-PT/docs/JavaScript/Referência/Global_Objects/Array/prototype	/docs/en/JavaScript/Reference/Global_Objects/Array/prototype
/pt-PT/docs/JavaScript/Referência/Global_Objects/Array/push	/docs/en/JavaScript/Reference/Global_Objects/Array/push
/pt-PT/docs/JavaScript/Referência/Global_Objects/Array/reverse	/docs/en/JavaScript/Reference/Global_Objects/Array/reverse
/pt-PT/docs/JavaScript/Referência/Global_Objects/Array/shift	/docs/en/JavaScript/Reference/Global_Objects/Array/shift
/pt-PT/docs/JavaScript/Referência/Global_Objects/Array/slice	/docs/en/JavaScript/Reference/Global_Objects/Array/slice
/pt-PT/docs/JavaScript/Referência/Global_Objects/Array/some	/docs/en/JavaScript/Reference/Global_Objects/Array/some
/pt-PT/docs/JavaScript/Referência/Global_Objects/Array/sort	/docs/en/JavaScript/Reference/Global_Objects/Array/sort
/pt-PT/docs/JavaScript/Referência/Global_Objects/Array/splice	/docs/en/JavaScript/Reference/Global_Objects/Array/splice
/pt-PT/docs/JavaScript/Referência/Global_Objects/Array/toSource	/docs/en/JavaScript/Reference/Global_Objects/Array/toSource
/pt-PT/docs/JavaScript/Referência/Global_Objects/Array/toString	/docs/en/JavaScript/Reference/Global_Objects/Array/toString
/pt-PT/docs/JavaScript/Referência/Global_Objects/Array/unshift	/docs/en/JavaScript/Reference/Global_Objects/Array/unshift
/pt-PT/docs/JavaScript/Referência/Global_Objects/Boolean	/docs/en/JavaScript/Reference/Global_Objects/Boolean
/pt-PT/docs/JavaScript/Referência/Global_Objects/Boolean/constructor	/docs/en/JavaScript/Reference/Global_Objects/Boolean/constructor
/pt-PT/docs/JavaScript/Referência/Global_Objects/Boolean/prototype	/docs/en/JavaScript/Reference/Global_Objects/Boolean/prototype
/pt-PT/docs/JavaScript/Referência/Global_Objects/Boolean/toSource	/docs/en/JavaScript/Reference/Global_Objects/Boolean/toSource
/pt-PT/docs/JavaScript/Referência/Global_Objects/Boolean/toString	/docs/en/JavaScript/Reference/Global_Objects/Boolean/toString
/pt-PT/docs/JavaScript/Referência/Global_Objects/Boolean/valueOf	/docs/en/JavaScript/Reference/Global_Objects/Boolean/valueOf
/pt-PT/docs/JavaScript/Referência/Global_Objects/Date	/docs/en/JavaScript/Reference/Global_Objects/Date
/pt-PT/docs/JavaScript/Referência/Global_Objects/Date/UTC	/docs/en/JavaScript/Reference/Global_Objects/Date/UTC
/pt-PT/docs/JavaScript/Referência/Global_Objects/Date/constructor	/docs/en/JavaScript/Reference/Global_Objects/Date/constructor
/pt-PT/docs/JavaScript/Referência/Global_Objects/Date/getDate	/docs/en/JavaScript/Reference/Global_Objects/Date/getDate
/pt-PT/docs/JavaScript/Referência/Global_Objects/Date/getDay	/docs/en/JavaScript/Reference/Global_Objects/Date/getDay
/pt-PT/docs/JavaScript/Referência/Global_Objects/Date/getFullYear	/docs/en/JavaScript/Reference/Global_Objects/Date/getFullYear
/pt-PT/docs/JavaScript/Referência/Global_Objects/Date/getHours	/docs/en/JavaScript/Reference/Global_Objects/Date/getHours
/pt-PT/docs/JavaScript/Referência/Global_Objects/Date/getMilliseconds	/docs/en/JavaScript/Reference/Global_Objects/Date/getMilliseconds
/pt-PT/docs/JavaScript/Referência/Global_Objects/Date/getMinutes	/docs/en/JavaScript/Reference/Global_Objects/Date/getMinutes
/pt-PT/docs/JavaScript/Referência/Global_Objects/Date/getMonth	/docs/en/JavaScript/Reference/Global_Objects/Date/getMonth
/pt-PT/docs/JavaScript/Referência/Global_Objects/Date/getSeconds	/docs/en/JavaScript/Reference/Global_Objects/Date/getSeconds
/pt-PT/docs/JavaScript/Referência/Global_Objects/Date/getTime	/docs/en/JavaScript/Reference/Global_Objects/Date/getTime
/pt-PT/docs/JavaScript/Referência/Global_Objects/Date/getTimezoneOffset	/docs/en/JavaScript/Reference/Global_Objects/Date/getTimezoneOffset
/pt-PT/docs/JavaScript/Referência/Global_Objects/Date/getUTCDate	/docs/en/JavaScript/Reference/Global_Objects/Date/getUTCDate
/pt-PT/docs/JavaScript/Referência/Global_Objects/Date/getUTCDay	/docs/en/JavaScript/Reference/Global_Objects/Date/getUTCDay
/pt-PT/docs/JavaScript/Referência/Global_Objects/Date/getUTCFullYear	/docs/en/JavaScript/Reference/Global_Objects/Date/getUTCFullYear
/pt-PT/docs/JavaScript/Referência/Global_Objects/Date/getUTCHours	/docs/en/JavaScript/Reference/Global_Objects/Date/getUTCHours
/pt-PT/docs/JavaScript/Referência/Global_Objects/Date/getUTCMilliseconds	/docs/en/JavaScript/Reference/Global_Objects/Date/getUTCMilliseconds
/pt-PT/docs/JavaScript/Referência/Global_Objects/Date/getUTCMinutes	/docs/en/JavaScript/Reference/Global_Objects/Date/getUTCMinutes
/pt-PT/docs/JavaScript/Referência/Global_Objects/Date/getUTCMonth	/docs/en/JavaScript/Reference/Global_Objects/Date/getUTCMonth
/pt-PT/docs/JavaScript/Referência/Global_Objects/Date/getUTCSeconds	/docs/en/JavaScript/Reference/Global_Objects/Date/getUTCSeconds
/pt-PT/docs/JavaScript/Referência/Global_Objects/Date/getYear	/docs/en/JavaScript/Reference/Global_Objects/Date/getYear
/pt-PT/docs/JavaScript/Referência/Global_Objects/Date/now	/docs/en/JavaScript/Reference/Global_Objects/Date/now
/pt-PT/docs/JavaScript/Referência/Global_Objects/Date/parse	/docs/en/JavaScript/Reference/Global_Objects/Date/parse
/pt-PT/docs/JavaScript/Referência/Global_Objects/Date/prototype	/docs/en/JavaScript/Reference/Global_Objects/Date/prototype
/pt-PT/docs/JavaScript/Referência/Global_Objects/Date/setDate	/docs/en/JavaScript/Reference/Global_Objects/Date/setDate
/pt-PT/docs/JavaScript/Referência/Global_Objects/Date/setFullYear	/docs/en/JavaScript/Reference/Global_Objects/Date/setFullYear
/pt-PT/docs/JavaScript/Referência/Global_Objects/Date/setHours	/docs/en/JavaScript/Reference/Global_Objects/Date/setHours
/pt-PT/docs/JavaScript/Referência/Global_Objects/Date/setMilliseconds	/docs/en/JavaScript/Reference/Global_Objects/Date/setMilliseconds
/pt-PT/docs/JavaScript/Referência/Global_Objects/Date/setMinutes	/docs/en/JavaScript/Reference/Global_Objects/Date/setMinutes
/pt-PT/docs/JavaScript/Referência/Global_Objects/Date/setMonth	/docs/en/JavaScript/Reference/Global_Objects/Date/setMonth
/pt-PT/docs/JavaScript/Referência/Global_Objects/Date/setSeconds	/docs/en/JavaScript/Reference/Global_Objects/Date/setSeconds
/pt-PT/docs/JavaScript/Referência/Global_Objects/Date/setTime	/docs/en/JavaScript/Reference/Global_Objects/Date/setTime
/pt-PT/docs/JavaScript/Referência/Global_Objects/Date/setUTCDate	/docs/en/JavaScript/Reference/Global_Objects/Date/setUTCDate
/pt-PT/docs/JavaScript/Referência/Global_Objects/Date/setUTCFullYear	/docs/en/JavaScript/Reference/Global_Objects/Date/setUTCFullYear
/pt-PT/docs/JavaScript/Referência/Global_Objects/Date/setUTCHours	/docs/en/JavaScript/Reference/Global_Objects/Date/setUTCHours
/pt-PT/docs/JavaScript/Referência/Global_Objects/Date/setUTCMilliseconds	/docs/en/JavaScript/Reference/Global_Objects/Date/setUTCMilliseconds
/pt-PT/docs/JavaScript/Referência/Global_Objects/Date/setUTCMinutes	/docs/en/JavaScript/Reference/Global_Objects/Date/setUTCMinutes
/pt-PT/docs/JavaScript/Referência/Global_Objects/Date/setUTCMonth	/docs/en/JavaScript/Reference/Global_Objects/Date/setUTCMonth
/pt-PT/docs/JavaScript/Referência/Global_Objects/Date/setUTCSeconds	/docs/en/JavaScript/Reference/Global_Objects/Date/setUTCSeconds
/pt-PT/docs/JavaScript/Referência/Global_Objects/Date/setYear	/docs/en/JavaScript/Reference/Global_Objects/Date/setYear
/pt-PT/docs/JavaScript/Referência/Global_Objects/Date/toDateString	/docs/en/JavaScript/Reference/Global_Objects/Date/toDateString
/pt-PT/docs/JavaScript/Referência/Global_Objects/Date/toGMTString	/docs/en/JavaScript/Reference/Global_Objects/Date/toGMTString
/pt-PT/docs/JavaScript/Referência/Global_Objects/Date/toISOString	/docs/en/JavaScript/Reference/Global_Objects/Date/toISOString
/pt-PT/docs/JavaScript/Referência/Global_Objects/Date/toJSON	/docs/en/JavaScript/Reference/Global_Objects/Date/toJSON
/pt-PT/docs/JavaScript/Referência/Global_Objects/Date/toLocaleDateString	/docs/en/JavaScript/Reference/Global_Objects/Date/toLocaleDateString
/pt-PT/docs/JavaScript/Referência/Global_Objects/Date/toLocaleFormat	/docs/en/JavaScript/Reference/Global_Objects/Date/toLocaleFormat
/pt-PT/docs/JavaScript/Referência/Global_Objects/Date/toLocaleString	/docs/en/JavaScript/Reference/Global_Objects/Date/toLocaleString
/pt-PT/docs/JavaScript/Referência/Global_Objects/Date/toLocaleTimeString	/docs/en/JavaScript/Reference/Global_Objects/Date/toLocaleTimeString
/pt-PT/docs/JavaScript/Referência/Global_Objects/Date/toSource	/docs/en/JavaScript/Reference/Global_Objects/Date/toSource
/pt-PT/docs/JavaScript/Referência/Global_Objects/Date/toString	/docs/en/JavaScript/Reference/Global_Objects/Date/toString
/pt-PT/docs/JavaScript/Referência/Global_Objects/Date/toTimeString	/docs/en/JavaScript/Reference/Global_Objects/Date/toTimeString
/pt-PT/docs/JavaScript/Referência/Global_Objects/Date/toUTCString	/docs/en/JavaScript/Reference/Global_Objects/Date/toUTCString
/pt-PT/docs/JavaScript/Referência/Global_Objects/Date/valueOf	/docs/en/JavaScript/Reference/Global_Objects/Date/valueOf
/pt-PT/docs/JavaScript/Referência/Global_Objects/Error	/docs/en/JavaScript/Reference/Global_Objects/Error
/pt-PT/docs/JavaScript/Referência/Global_Objects/Error/Stack	/docs/en/JavaScript/Reference/Global_Objects/Error/Stack
/pt-PT/docs/JavaScript/Referência/Global_Objects/Error/message	/docs/en/JavaScript/Reference/Global_Objects/Error/message
/pt-PT/docs/JavaScript/Referência/Global_Objects/Error/name	/docs/en/JavaScript/Reference/Global_Objects/Error/name
/pt-PT/docs/JavaScript/Referência/Global_Objects/Error/prototype	/docs/en/JavaScript/Reference/Global_Objects/Error/prototype
/pt-PT/docs/JavaScript/Referência/Global_Objects/Error/toSource	/docs/en/JavaScript/Reference/Global_Objects/Error/toSource
/pt-PT/docs/JavaScript/Referência/Global_Objects/Error/toString	/docs/en/JavaScript/Reference/Global_Objects/Error/toString
/pt-PT/docs/JavaScript/Referência/Global_Objects/EvalError	/docs/en/JavaScript/Reference/Global_Objects/EvalError
/pt-PT/docs/JavaScript/Referência/Global_Objects/EvalError/prototype	/docs/en/JavaScript/Reference/Global_Objects/EvalError/prototype
/pt-PT/docs/JavaScript/Referência/Global_Objects/Function	/docs/en/JavaScript/Reference/Global_Objects/Function
/pt-PT/docs/JavaScript/Referência/Global_Objects/Function/apply	/docs/en/JavaScript/Reference/Global_Objects/Function/apply
/pt-PT/docs/JavaScript/Referência/Global_Objects/Function/arguments	/docs/en/JavaScript/Reference/Global_Objects/Function/arguments
/pt-PT/docs/JavaScript/Referência/Global_Objects/Function/arity	/docs/en/JavaScript/Reference/Global_Objects/Function/arity
/pt-PT/docs/JavaScript/Referência/Global_Objects/Function/bind	/docs/en/JavaScript/Reference/Global_Objects/Function/bind
/pt-PT/docs/JavaScript/Referência/Global_Objects/Function/call	/docs/en/JavaScript/Reference/Global_Objects/Function/call
/pt-PT/docs/JavaScript/Referência/Global_Objects/Function/caller	/docs/en/JavaScript/Reference/Global_Objects/Function/caller
/pt-PT/docs/JavaScript/Referência/Global_Objects/Function/constructor	/docs/en/JavaScript/Reference/Global_Objects/Function/constructor
/pt-PT/docs/JavaScript/Referência/Global_Objects/Function/isGenerator	/docs/en/JavaScript/Reference/Global_Objects/Function/isGenerator
/pt-PT/docs/JavaScript/Referência/Global_Objects/Function/length	/docs/en/JavaScript/Reference/Global_Objects/Function/length
/pt-PT/docs/JavaScript/Referência/Global_Objects/Function/name	/docs/en/JavaScript/Reference/Global_Objects/Function/name
/pt-PT/docs/JavaScript/Referência/Global_Objects/Function/prototype	/docs/en/JavaScript/Reference/Global_Objects/Function/prototype
/pt-PT/docs/JavaScript/Referência/Global_Objects/Function/toSource	/docs/en/JavaScript/Reference/Global_Objects/Function/toSource
/pt-PT/docs/JavaScript/Referência/Global_Objects/Function/toString	/docs/en/JavaScript/Reference/Global_Objects/Function/toString
/pt-PT/docs/JavaScript/Referência/Global_Objects/Generator	/docs/en/JavaScript/Reference/Global_Objects/Generator
/pt-PT/docs/JavaScript/Referência/Global_Objects/Infinity	/docs/en/JavaScript/Reference/Global_Objects/Infinity
/pt-PT/docs/JavaScript/Referência/Global_Objects/JSON	/docs/en/JavaScript/Reference/Global_Objects/JSON
/pt-PT/docs/JavaScript/Referência/Global_Objects/JSON/parse	/docs/en/JavaScript/Reference/Global_Objects/JSON/parse
/pt-PT/docs/JavaScript/Referência/Global_Objects/JSON/stringify	/docs/en/JavaScript/Reference/Global_Objects/JSON/stringify
/pt-PT/docs/JavaScript/Referência/Global_Objects/Math	/docs/en/JavaScript/Reference/Global_Objects/Math
/pt-PT/docs/JavaScript/Referência/Global_Objects/Math/E	/docs/en/JavaScript/Reference/Global_Objects/Math/E
/pt-PT/docs/JavaScript/Referência/Global_Objects/Math/LN10	/docs/en/JavaScript/Reference/Global_Objects/Math/LN10
/pt-PT/docs/JavaScript/Referência/Global_Objects/Math/LN2	/docs/en/JavaScript/Reference/Global_Objects/Math/LN2
/pt-PT/docs/JavaScript/Referência/Global_Objects/Math/LOG10E	/docs/en/JavaScript/Reference/Global_Objects/Math/LOG10E
/pt-PT/docs/JavaScript/Referência/Global_Objects/Math/LOG2E	/docs/en/JavaScript/Reference/Global_Objects/Math/LOG2E
/pt-PT/docs/JavaScript/Referência/Global_Objects/Math/PI	/docs/en/JavaScript/Reference/Global_Objects/Math/PI
/pt-PT/docs/JavaScript/Referência/Global_Objects/Math/SQRT1_2	/docs/en/JavaScript/Reference/Global_Objects/Math/SQRT1_2
/pt-PT/docs/JavaScript/Referência/Global_Objects/Math/SQRT2	/docs/en/JavaScript/Reference/Global_Objects/Math/SQRT2
/pt-PT/docs/JavaScript/Referência/Global_Objects/Math/abs	/docs/en/JavaScript/Reference/Global_Objects/Math/abs
/pt-PT/docs/JavaScript/Referência/Global_Objects/Math/acos	/docs/en/JavaScript/Reference/Global_Objects/Math/acos
/pt-PT/docs/JavaScript/Referência/Global_Objects/Math/asin	/docs/en/JavaScript/Reference/Global_Objects/Math/asin
/pt-PT/docs/JavaScript/Referência/Global_Objects/Math/atan	/docs/en/JavaScript/Reference/Global_Objects/Math/atan
/pt-PT/docs/JavaScript/Referência/Global_Objects/Math/atan2	/docs/en/JavaScript/Reference/Global_Objects/Math/atan2
/pt-PT/docs/JavaScript/Referência/Global_Objects/Math/ceil	/docs/en/JavaScript/Reference/Global_Objects/Math/ceil
/pt-PT/docs/JavaScript/Referência/Global_Objects/Math/cos	/docs/en/JavaScript/Reference/Global_Objects/Math/cos
/pt-PT/docs/JavaScript/Referência/Global_Objects/Math/exp	/docs/en/JavaScript/Reference/Global_Objects/Math/exp
/pt-PT/docs/JavaScript/Referência/Global_Objects/Math/floor	/docs/en/JavaScript/Reference/Global_Objects/Math/floor
/pt-PT/docs/JavaScript/Referência/Global_Objects/Math/log	/docs/en/JavaScript/Reference/Global_Objects/Math/log
/pt-PT/docs/JavaScript/Referência/Global_Objects/Math/max	/docs/en/JavaScript/Reference/Global_Objects/Math/max
/pt-PT/docs/JavaScript/Referência/Global_Objects/Math/min	/docs/en/JavaScript/Reference/Global_Objects/Math/min
/pt-PT/docs/JavaScript/Referência/Global_Objects/Math/pow	/docs/en/JavaScript/Reference/Global_Objects/Math/pow
/pt-PT/docs/JavaScript/Referência/Global_Objects/Math/random	/docs/en/JavaScript/Reference/Global_Objects/Math/random
/pt-PT/docs/JavaScript/Referência/Global_Objects/Math/round	/docs/en/JavaScript/Reference/Global_Objects/Math/round
/pt-PT/docs/JavaScript/Referência/Global_Objects/Math/sin	/docs/en/JavaScript/Reference/Global_Objects/Math/sin
/pt-PT/docs/JavaScript/Referência/Global_Objects/Math/sqrt	/docs/en/JavaScript/Reference/Global_Objects/Math/sqrt
/pt-PT/docs/JavaScript/Referência/Global_Objects/Math/tan	/docs/en/JavaScript/Reference/Global_Objects/Math/tan
/pt-PT/docs/JavaScript/Referência/Global_Objects/NaN	/docs/en/JavaScript/Reference/Global_Objects/NaN
/pt-PT/docs/JavaScript/Referência/Global_Objects/Number	/docs/en/JavaScript/Reference/Global_Objects/Number
/pt-PT/docs/JavaScript/Referência/Global_Objects/Number/MAX_VALUE	/docs/en/JavaScript/Reference/Global_Objects/Number/MAX_VALUE
/pt-PT/docs/JavaScript/Referência/Global_Objects/Number/MIN_VALUE	/docs/en/JavaScript/Reference/Global_Objects/Number/MIN_VALUE
/pt-PT/docs/JavaScript/Referência/Global_Objects/Number/NEGATIVE_INFINITY	/docs/en/JavaScript/Reference/Global_Objects/Number/NEGATIVE_INFINITY
/pt-PT/docs/JavaScript/Referência/Global_Objects/Number/NaN	/docs/en/JavaScript/Reference/Global_Objects/Number/NaN
/pt-PT/docs/JavaScript/Referência/Global_Objects/Number/POSITIVE_INFINITY	/docs/en/JavaScript/Reference/Global_Objects/Number/POSITIVE_INFINITY
/pt-PT/docs/JavaScript/Referência/Global_Objects/Number/ToLocaleString	/docs/en/JavaScript/Reference/Global_Objects/Number/ToLocaleString
/pt-PT/docs/JavaScript/Referência/Global_Objects/Number/constructor	/docs/en/JavaScript/Reference/Global_Objects/Number/constructor
/pt-PT/docs/JavaScript/Referência/Global_Objects/Number/prototype	/docs/en/JavaScript/Reference/Global_Objects/Number/prototype
/pt-PT/docs/JavaScript/Referência/Global_Objects/Number/toExponential	/docs/en/JavaScript/Reference/Global_Objects/Number/toExponential
/pt-PT/docs/JavaScript/Referência/Global_Objects/Number/toFixed	/docs/en/JavaScript/Reference/Global_Objects/Number/toFixed
/pt-PT/docs/JavaScript/Referência/Global_Objects/Number/toPrecision	/docs/en/JavaScript/Reference/Global_Objects/Number/toPrecision
/pt-PT/docs/JavaScript/Referência/Global_Objects/Number/toSource	/docs/en/JavaScript/Reference/Global_Objects/Number/toSource
/pt-PT/docs/JavaScript/Referência/Global_Objects/Number/toString	/docs/en/JavaScript/Reference/Global_Objects/Number/toString
/pt-PT/docs/JavaScript/Referência/Global_Objects/Number/valueOf	/docs/en/JavaScript/Reference/Global_Objects/Number/valueOf
/pt-PT/docs/JavaScript/Referência/Global_Objects/Object	/docs/en/JavaScript/Reference/Global_Objects/Object
/pt-PT/docs/JavaScript/Referência/Global_Objects/Object/GetPrototypeOf	/docs/en/JavaScript/Reference/Global_Objects/Object/GetPrototypeOf
/pt-PT/docs/JavaScript/Referência/Global_Objects/Object/Parent	/docs/en/JavaScript/Reference/Global_Objects/Object/Parent
/pt-PT/docs/JavaScript/Referência/Global_Objects/Object/constructor	/docs/en/JavaScript/Reference/Global_Objects/Object/constructor
/pt-PT/docs/JavaScript/Referência/Global_Objects/Object/create	/docs/en/JavaScript/Reference/Global_Objects/Object/create
/pt-PT/docs/JavaScript/Referência/Global_Objects/Object/defineGetter	/docs/en/JavaScript/Reference/Global_Objects/Object/defineGetter
/pt-PT/docs/JavaScript/Referência/Global_Objects/Object/defineProperties	/docs/en/JavaScript/Reference/Global_Objects/Object/defineProperties
/pt-PT/docs/JavaScript/Referência/Global_Objects/Object/defineProperty	/docs/en/JavaScript/Reference/Global_Objects/Object/defineProperty
/pt-PT/docs/JavaScript/Referência/Global_Objects/Object/defineSetter	/docs/en/JavaScript/Reference/Global_Objects/Object/defineSetter
/pt-PT/docs/JavaScript/Referência/Global_Objects/Object/eval	/docs/en/JavaScript/Reference/Global_Objects/Object/eval
/pt-PT/docs/JavaScript/Referência/Global_Objects/Object/freeze	/docs/en/JavaScript/Reference/Global_Objects/Object/freeze
/pt-PT/docs/JavaScript/Referência/Global_Objects/Object/getOwnPropertyDescriptor	/docs/en/JavaScript/Reference/Global_Objects/Object/getOwnPropertyDescriptor
/pt-PT/docs/JavaScript/Referência/Global_Objects/Object/getOwnPropertyNames	/docs/en/JavaScript/Reference/Global_Objects/Object/getOwnPropertyNames
/pt-PT/docs/JavaScript/Referência/Global_Objects/Object/hasOwnProperty	/docs/en/JavaScript/Reference/Global_Objects/Object/hasOwnProperty
/pt-PT/docs/JavaScript/Referência/Global_Objects/Object/isExtensible	/docs/en/JavaScript/Reference/Global_Objects/Object/isExtensible
/pt-PT/docs/JavaScript/Referência/Global_Objects/Object/isFrozen	/docs/en/JavaScript/Reference/Global_Objects/Object/isFrozen
/pt-PT/docs/JavaScript/Referência/Global_Objects/Object/isPrototypeOf	/docs/en/JavaScript/Reference/Global_Objects/Object/isPrototypeOf
/pt-PT/docs/JavaScript/Referência/Global_Objects/Object/isSealed	/docs/en/JavaScript/Reference/Global_Objects/Object/isSealed
/pt-PT/docs/JavaScript/Referência/Global_Objects/Object/keys	/docs/en/JavaScript/Reference/Global_Objects/Object/keys
/pt-PT/docs/JavaScript/Referência/Global_Objects/Object/lookupGetter	/docs/en/JavaScript/Reference/Global_Objects/Object/lookupGetter
/pt-PT/docs/JavaScript/Referência/Global_Objects/Object/lookupSetter	/docs/en/JavaScript/Reference/Global_Objects/Object/lookupSetter
/pt-PT/docs/JavaScript/Referência/Global_Objects/Object/noSuchMethod	/docs/en/JavaScript/Reference/Global_Objects/Object/noSuchMethod
/pt-PT/docs/JavaScript/Referência/Global_Objects/Object/preventExtensions	/docs/en/JavaScript/Reference/Global_Objects/Object/preventExtensions
/pt-PT/docs/JavaScript/Referência/Global_Objects/Object/propertyIsEnumerable	/docs/en/JavaScript/Reference/Global_Objects/Object/propertyIsEnumerable
/pt-PT/docs/JavaScript/Referência/Global_Objects/Object/proto	/docs/en/JavaScript/Reference/Global_Objects/Object/proto
/pt-PT/docs/JavaScript/Referência/Global_Objects/Object/prototype	/docs/en/JavaScript/Reference/Global_Objects/Object/prototype
/pt-PT/docs/JavaScript/Referência/Global_Objects/Object/seal	/docs/en/JavaScript/Reference/Global_Objects/Object/seal
/pt-PT/docs/JavaScript/Referência/Global_Objects/Object/toLocaleString	/docs/en/JavaScript/Reference/Global_Objects/Object/toLocaleString
/pt-PT/docs/JavaScript/Referência/Global_Objects/Object/toSource	/docs/en/JavaScript/Reference/Global_Objects/Object/toSource
/pt-PT/docs/JavaScript/Referência/Global_Objects/Object/toString	/docs/en/JavaScript/Reference/Global_Objects/Object/toString
/pt-PT/docs/JavaScript/Referência/Global_Objects/Object/unwatch	/docs/en/JavaScript/Reference/Global_Objects/Object/unwatch
/pt-PT/docs/JavaScript/Referência/Global_Objects/Object/valueOf	/docs/en/JavaScript/Reference/Global_Objects/Object/valueOf
/pt-PT/docs/JavaScript/Referência/Global_Objects/Object/watch	/docs/en/JavaScript/Reference/Global_Objects/Object/watch
/pt-PT/docs/JavaScript/Referência/Global_Objects/Proxy	/docs/en/JavaScript/Reference/Global_Objects/Proxy
/pt-PT/docs/JavaScript/Referência/Global_Objects/RangeError	/docs/en/JavaScript/Reference/Global_Objects/RangeError
/pt-PT/docs/JavaScript/Referência/Global_Objects/RangeError/prototype	/docs/en/JavaScript/Reference/Global_Objects/RangeError/prototype
/pt-PT/docs/JavaScript/Referência/Global_Objects/ReferenceError	/docs/en/JavaScript/Reference/Global_Objects/ReferenceError
/pt-PT/docs/JavaScript/Referência/Global_Objects/ReferenceError/name	/docs/en/JavaScript/Reference/Global_Objects/ReferenceError/name
/pt-PT/docs/JavaScript/Referência/Global_Objects/ReferenceError/prototype	/docs/en/JavaScript/Reference/Global_Objects/ReferenceError/prototype
/pt-PT/docs/JavaScript/Referência/Global_Objects/RegExp	/docs/en/JavaScript/Reference/Global_Objects/RegExp
/pt-PT/docs/JavaScript/Referência/Global_Objects/RegExp/constructor	/docs/en/JavaScript/Reference/Global_Objects/RegExp/constructor
/pt-PT/docs/JavaScript/Referência/Global_Objects/RegExp/exec	/docs/en/JavaScript/Reference/Global_Objects/RegExp/exec
/pt-PT/docs/JavaScript/Referência/Global_Objects/RegExp/global	/docs/en/JavaScript/Reference/Global_Objects/RegExp/global
/pt-PT/docs/JavaScript/Referência/Global_Objects/RegExp/ignoreCase	/docs/en/JavaScript/Reference/Global_Objects/RegExp/ignoreCase
/pt-PT/docs/JavaScript/Referência/Global_Objects/RegExp/lastIndex	/docs/en/JavaScript/Reference/Global_Objects/RegExp/lastIndex
/pt-PT/docs/JavaScript/Referência/Global_Objects/RegExp/multiline	/docs/en/JavaScript/Reference/Global_Objects/RegExp/multiline
/pt-PT/docs/JavaScript/Referência/Global_Objects/RegExp/prototype	/docs/en/JavaScript/Reference/Global_Objects/RegExp/prototype
/pt-PT/docs/JavaScript/Referência/Global_Objects/RegExp/source	/docs/en/JavaScript/Reference/Global_Objects/RegExp/source
/pt-PT/docs/JavaScript/Referência/Global_Objects/RegExp/test	/docs/en/JavaScript/Reference/Global_Objects/RegExp/test
/pt-PT/docs/JavaScript/Referência/Global_Objects/RegExp/toSource	/docs/en/JavaScript/Reference/Global_Objects/RegExp/toSource
/pt-PT/docs/JavaScript/Referência/Global_Objects/RegExp/toString	/docs/en/JavaScript/Reference/Global_Objects/RegExp/toString
/pt-PT/docs/JavaScript/Referência/Global_Objects/String	/docs/en/JavaScript/Reference/Global_Objects/String
/pt-PT/docs/JavaScript/Referência/Global_Objects/String/Trim	/docs/en/JavaScript/Reference/Global_Objects/String/Trim
/pt-PT/docs/JavaScript/Referência/Global_Objects/String/TrimLeft	/docs/en/JavaScript/Reference/Global_Objects/String/TrimLeft
/pt-PT/docs/JavaScript/Referência/Global_Objects/String/TrimRight	/docs/en/JavaScript/Reference/Global_Objects/String/TrimRight
/pt-PT/docs/JavaScript/Referência/Global_Objects/String/anchor	/docs/en/JavaScript/Reference/Global_Objects/String/anchor
/pt-PT/docs/JavaScript/Referência/Global_Objects/String/big	/docs/en/JavaScript/Reference/Global_Objects/String/big
/pt-PT/docs/JavaScript/Referência/Global_Objects/String/blink	/docs/en/JavaScript/Reference/Global_Objects/String/blink
/pt-PT/docs/JavaScript/Referência/Global_Objects/String/bold	/docs/en/JavaScript/Reference/Global_Objects/String/bold
/pt-PT/docs/JavaScript/Referência/Global_Objects/String/charAt	/docs/en/JavaScript/Reference/Global_Objects/String/charAt
/pt-PT/docs/JavaScript/Referência/Global_Objects/String/charCodeAt	/docs/en/JavaScript/Reference/Global_Objects/String/charCodeAt
/pt-PT/docs/JavaScript/Referência/Global_Objects/String/concat	/docs/en/JavaScript/Reference/Global_Objects/String/concat
/pt-PT/docs/JavaScript/Referência/Global_Objects/String/constructor	/docs/en/JavaScript/Reference/Global_Objects/String/constructor
/pt-PT/docs/JavaScript/Referência/Global_Objects/String/fixed	/docs/en/JavaScript/Reference/Global_Objects/String/fixed
/pt-PT/docs/JavaScript/Referência/Global_Objects/String/fontcolor	/docs/en/JavaScript/Reference/Global_Objects/String/fontcolor
/pt-PT/docs/JavaScript/Referência/Global_Objects/String/fontsize	/docs/en/JavaScript/Reference/Global_Objects/String/fontsize
/pt-PT/docs/JavaScript/Referência/Global_Objects/String/fromCharCode	/docs/en/JavaScript/Reference/Global_Objects/String/fromCharCode
/pt-PT/docs/JavaScript/Referência/Global_Objects/String/indexOf	/docs/en/JavaScript/Reference/Global_Objects/String/indexOf
/pt-PT/docs/JavaScript/Referência/Global_Objects/String/italics	/docs/en/JavaScript/Reference/Global_Objects/String/italics
/pt-PT/docs/JavaScript/Referência/Global_Objects/String/lastIndexOf	/docs/en/JavaScript/Reference/Global_Objects/String/lastIndexOf
/pt-PT/docs/JavaScript/Referência/Global_Objects/String/length	/docs/en/JavaScript/Reference/Global_Objects/String/length
/pt-PT/docs/JavaScript/Referência/Global_Objects/String/link	/docs/en/JavaScript/Reference/Global_Objects/String/link
/pt-PT/docs/JavaScript/Referência/Global_Objects/String/localeCompare	/docs/en/JavaScript/Reference/Global_Objects/String/localeCompare
/pt-PT/docs/JavaScript/Referência/Global_Objects/String/match	/docs/en/JavaScript/Reference/Global_Objects/String/match
/pt-PT/docs/JavaScript/Referência/Global_Objects/String/prototype	/docs/en/JavaScript/Reference/Global_Objects/String/prototype
/pt-PT/docs/JavaScript/Referência/Global_Objects/String/quote	/docs/en/JavaScript/Reference/Global_Objects/String/quote
/pt-PT/docs/JavaScript/Referência/Global_Objects/String/replace	/docs/en/JavaScript/Reference/Global_Objects/String/replace
/pt-PT/docs/JavaScript/Referência/Global_Objects/String/search	/docs/en/JavaScript/Reference/Global_Objects/String/search
/pt-PT/docs/JavaScript/Referência/Global_Objects/String/slice	/docs/en/JavaScript/Reference/Global_Objects/String/slice
/pt-PT/docs/JavaScript/Referência/Global_Objects/String/small	/docs/en/JavaScript/Reference/Global_Objects/String/small
/pt-PT/docs/JavaScript/Referência/Global_Objects/String/split	/docs/en/JavaScript/Reference/Global_Objects/String/split
/pt-PT/docs/JavaScript/Referência/Global_Objects/String/strike	/docs/en/JavaScript/Reference/Global_Objects/String/strike
/pt-PT/docs/JavaScript/Referência/Global_Objects/String/sub	/docs/en/JavaScript/Reference/Global_Objects/String/sub
/pt-PT/docs/JavaScript/Referência/Global_Objects/String/substr	/docs/en/JavaScript/Reference/Global_Objects/String/substr
/pt-PT/docs/JavaScript/Referência/Global_Objects/String/substring	/docs/en/JavaScript/Reference/Global_Objects/String/substring
/pt-PT/docs/JavaScript/Referência/Global_Objects/String/sup	/docs/en/JavaScript/Reference/Global_Objects/String/sup
/pt-PT/docs/JavaScript/Referência/Global_Objects/String/toLocaleLowerCase	/docs/en/JavaScript/Reference/Global_Objects/String/toLocaleLowerCase
/pt-PT/docs/JavaScript/Referência/Global_Objects/String/toLocaleUpperCase	/docs/en/JavaScript/Reference/Global_Objects/String/toLocaleUpperCase
/pt-PT/docs/JavaScript/Referência/Global_Objects/String/toLowerCase	/docs/en/JavaScript/Reference/Global_Objects/String/toLowerCase
/pt-PT/docs/JavaScript/Referência/Global_Objects/String/toSource	/docs/en/JavaScript/Reference/Global_Objects/String/toSource
/pt-PT/docs/JavaScript/Referência/Global_Objects/String/toString	/docs/en/JavaScript/Reference/Global_Objects/String/toString
/pt-PT/docs/JavaScript/Referência/Global_Objects/String/toUpperCase	/docs/en/JavaScript/Reference/Global_Objects/String/toUpperCase
/pt-PT/docs/JavaScript/Referência/Global_Objects/String/valueOf	/docs/en/JavaScript/Reference/Global_Objects/String/valueOf
/pt-PT/docs/JavaScript/Referência/Global_Objects/SyntaxError	/docs/en/JavaScript/Reference/Global_Objects/SyntaxError
/pt-PT/docs/JavaScript/Referência/Global_Objects/SyntaxError/prototype	/docs/en/JavaScript/Reference/Global_Objects/SyntaxError/prototype
/pt-PT/docs/JavaScript/Referência/Global_Objects/TypeError	/docs/en/JavaScript/Reference/Global_Objects/TypeError
/pt-PT/docs/JavaScript/Referência/Global_Objects/TypeError/prototype	/docs/en/JavaScript/Reference/Global_Objects/TypeError/prototype
/pt-PT/docs/JavaScript/Referência/Global_Objects/URIError	/docs/en/JavaScript/Reference/Global_Objects/URIError
/pt-PT/docs/JavaScript/Referência/Global_Objects/URIError/prototype	/docs/en/JavaScript/Reference/Global_Objects/URIError/prototype
/pt-PT/docs/JavaScript/Referência/Global_Objects/WeakMap	/docs/en/JavaScript/Reference/Global_Objects/WeakMap
/pt-PT/docs/JavaScript/Referência/Global_Objects/decodeURI	/docs/en/JavaScript/Reference/Global_Objects/decodeURI
/pt-PT/docs/JavaScript/Referência/Global_Objects/decodeURIComponent	/docs/en/JavaScript/Reference/Global_Objects/decodeURIComponent
/pt-PT/docs/JavaScript/Referência/Global_Objects/encodeURI	/docs/en/JavaScript/Reference/Global_Objects/encodeURI
/pt-PT/docs/JavaScript/Referência/Global_Objects/encodeURIComponent	/docs/en/JavaScript/Reference/Global_Objects/encodeURIComponent
/pt-PT/docs/JavaScript/Referência/Global_Objects/eval	/docs/en/JavaScript/Reference/Global_Objects/eval
/pt-PT/docs/JavaScript/Referência/Global_Objects/isFinite	/docs/en/JavaScript/Reference/Global_Objects/isFinite
/pt-PT/docs/JavaScript/Referência/Global_Objects/isNaN	/docs/en/JavaScript/Reference/Global_Objects/isNaN
/pt-PT/docs/JavaScript/Referência/Global_Objects/parseFloat	/docs/en/JavaScript/Reference/Global_Objects/parseFloat
/pt-PT/docs/JavaScript/Referência/Global_Objects/parseInt	/docs/en/JavaScript/Reference/Global_Objects/parseInt
/pt-PT/docs/JavaScript/Referência/Global_Objects/undefined	/docs/en/JavaScript/Reference/Global_Objects/undefined
/pt-PT/docs/JavaScript/Referência/Operators	/docs/en/JavaScript/Reference/Operators
/pt-PT/docs/JavaScript/Referência/Operators/Arithmetic_Operators	/docs/en/JavaScript/Reference/Operators/Arithmetic_Operators
/pt-PT/docs/JavaScript/Referência/Operators/Assignment_Operators	/docs/en/JavaScript/Reference/Operators/Assignment_Operators
/pt-PT/docs/JavaScript/Referência/Operators/Bitwise_Operators	/docs/en/JavaScript/Reference/Operators/Bitwise_Operators
/pt-PT/docs/JavaScript/Referência/Operators/Comparison_Operators	/docs/en/JavaScript/Reference/Operators/Comparison_Operators
/pt-PT/docs/JavaScript/Referência/Operators/Logical_Operators	/docs/en/JavaScript/Reference/Operators/Logical_Operators
/pt-PT/docs/JavaScript/Referência/Operators/Member_Operators	/docs/en/JavaScript/Reference/Operators/Member_Operators
/pt-PT/docs/JavaScript/Referência/Operators/Operator_Precedence	/docs/en/JavaScript/Reference/Operators/Operator_Precedence
/pt-PT/docs/JavaScript/Referência/Operators/Special	/docs/en/JavaScript/Reference/Operators/Special
/pt-PT/docs/JavaScript/Referência/Operators/Special/Comma_Operator	/docs/en/JavaScript/Reference/Operators/Comma_Operator
/pt-PT/docs/JavaScript/Referência/Operators/Special/Conditional_Operator	/docs/en/JavaScript/Reference/Operators/Conditional_Operator
/pt-PT/docs/JavaScript/Referência/Operators/Special/delete	/docs/en/JavaScript/Reference/Operators/delete
/pt-PT/docs/JavaScript/Referência/Operators/Special/function	/docs/en/JavaScript/Reference/Operators/function
/pt-PT/docs/JavaScript/Referência/Operators/Special/get	/docs/en/JavaScript/Reference/Operators/get
/pt-PT/docs/JavaScript/Referência/Operators/Special/in	/docs/en/JavaScript/Reference/Operators/in
/pt-PT/docs/JavaScript/Referência/Operators/Special/instanceof	/docs/en/JavaScript/Reference/Operators/instanceof
/pt-PT/docs/JavaScript/Referência/Operators/Special/new	/docs/en/JavaScript/Reference/Operators/new
/pt-PT/docs/JavaScript/Referência/Operators/Special/set	/docs/en/JavaScript/Reference/Operators/set
/pt-PT/docs/JavaScript/Referência/Operators/Special/this	/docs/en/JavaScript/Reference/Operators/this
/pt-PT/docs/JavaScript/Referência/Operators/Special/typeof	/docs/en/JavaScript/Reference/Operators/typeof
/pt-PT/docs/JavaScript/Referência/Operators/Special/void	/docs/en/JavaScript/Reference/Operators/void
/pt-PT/docs/JavaScript/Referência/Operators/String_Operators	/docs/en/JavaScript/Reference/Operators/String_Operators
/pt-PT/docs/JavaScript/Referência/Reserved_Words	/docs/en/JavaScript/Reference/Reserved_Words
/pt-PT/docs/JavaScript/Referência/Scope_Cheatsheet	/docs/en/JavaScript/Reference/Scope_Cheatsheet
/pt-PT/docs/JavaScript/Referência/Statements	/docs/en/JavaScript/Reference/Statements
/pt-PT/docs/JavaScript/Referência/Statements/block	/docs/en/JavaScript/Reference/Statements/block
/pt-PT/docs/JavaScript/Referência/Statements/break	/docs/en/JavaScript/Reference/Statements/break
/pt-PT/docs/JavaScript/Referência/Statements/const	/docs/en/JavaScript/Reference/Statements/const
/pt-PT/docs/JavaScript/Referência/Statements/continue	/docs/en/JavaScript/Reference/Statements/continue
/pt-PT/docs/JavaScript/Referência/Statements/debugger	/docs/en/JavaScript/Reference/Statements/debugger
/pt-PT/docs/JavaScript/Referência/Statements/do...while	/docs/en/JavaScript/Reference/Statements/do...while
/pt-PT/docs/JavaScript/Referência/Statements/export	/docs/en/JavaScript/Reference/Statements/export
/pt-PT/docs/JavaScript/Referência/Statements/for	/docs/en/JavaScript/Reference/Statements/for
/pt-PT/docs/JavaScript/Referência/Statements/for...in	/docs/en/JavaScript/Reference/Statements/for...in
/pt-PT/docs/JavaScript/Referência/Statements/for_each...in	/docs/en/JavaScript/Reference/Statements/for_each...in
/pt-PT/docs/JavaScript/Referência/Statements/function	/docs/en/JavaScript/Reference/Statements/function
/pt-PT/docs/JavaScript/Referência/Statements/if...else	/docs/en/JavaScript/Reference/Statements/if...else
/pt-PT/docs/JavaScript/Referência/Statements/import	/docs/en/JavaScript/Reference/Statements/import
/pt-PT/docs/JavaScript/Referência/Statements/label	/docs/en/JavaScript/Reference/Statements/label
/pt-PT/docs/JavaScript/Referência/Statements/let	/docs/en/JavaScript/Reference/Statements/let
/pt-PT/docs/JavaScript/Referência/Statements/return	/docs/en/JavaScript/Reference/Statements/return
/pt-PT/docs/JavaScript/Referência/Statements/switch	/docs/en/JavaScript/Reference/Statements/switch
/pt-PT/docs/JavaScript/Referência/Statements/throw	/docs/en/JavaScript/Reference/Statements/throw
/pt-PT/docs/JavaScript/Referência/Statements/try...catch	/docs/en/JavaScript/Reference/Statements/try...catch
/pt-PT/docs/JavaScript/Referência/Statements/var	/docs/en/JavaScript/Reference/Statements/var
/pt-PT/docs/JavaScript/Referência/Statements/while	/docs/en/JavaScript/Reference/Statements/while
/pt-PT/docs/JavaScript/Referência/Statements/with	/docs/en/JavaScript/Reference/Statements/with
/pt-PT/docs/JavaScript/Referência/Symbols	/docs/en/JavaScript/Reference/Symbols
/pt-PT/docs/JavaScript/Referência/Symbols/Page_Title	/docs/en/JavaScript/Reference/Symbols/Page_Title
/pt-PT/docs/JavaScript:Comunidade	/docs/pt/JavaScript/Comunidade
/pt-PT/docs/JavaScript:O_que_é_o_JavaScript	/docs/pt/JavaScript/O_que_%C3%A9_o_JavaScript
/pt-PT/docs/JavaScript:Outros_recursos	/docs/pt/JavaScript/Outros_recursos
/pt-PT/docs/Learn/CSS/Estilo_de_caixas	/en-US/docs/Learn/CSS/Building_blocks
/pt-PT/docs/Learn/CSS/Introduction_to_CSS	/en-US/docs/Learn/CSS/First_steps
/pt-PT/docs/Learn/CSS/Introduction_to_CSS/Seletores	/en-US/docs/Learn/CSS/Building_blocks/Selectors
/pt-PT/docs/Mozilla/Add-ons/WebExtensions/manifest.json/applications	/pt-PT/docs/Mozilla/Add-ons/WebExtensions/manifest.json/browser_specific_settings
/pt-PT/docs/Mozilla/B2G_OS	/pt-PT/docs/Archive/B2G_OS
/pt-PT/docs/Mozilla/B2G_OS/Developer_phone_guide	/pt-PT/docs/Archive/B2G_OS/Developer_phone_guide
/pt-PT/docs/Mozilla/B2G_OS/Developer_phone_guide/Flame	/pt-PT/docs/Archive/B2G_OS/Developer_phone_guide/Flame
/pt-PT/docs/Mozilla/B2G_OS/Utilizar_o_Gestor_de_Aplicacões	/pt-PT/docs/Archive/B2G_OS/Utilizar_o_Gestor_de_Aplicac%C3%B5es
/pt-PT/docs/Mozilla/Boot_to_Gecko	/pt-PT/docs/Mozilla/B2G_OS
/pt-PT/docs/Mozilla/Boot_to_Gecko/Utilizar_o_Gestor_de_Aplicacões	/pt-PT/docs/Mozilla/B2G_OS/Utilizar_o_Gestor_de_Aplicac%C3%B5es
/pt-PT/docs/Mozilla/Firefox_OS/Developer_phone_guide	/pt-PT/docs/Mozilla/B2G_OS/Developer_phone_guide
/pt-PT/docs/Mozilla/Firefox_OS/Developer_phone_guide/Flame	/pt-PT/docs/Mozilla/B2G_OS/Developer_phone_guide/Flame
/pt-PT/docs/Mozilla/Firefox_OS/Firefox_OS_apps	/pt-PT/docs/Archive/B2G_OS/Firefox_OS_apps
/pt-PT/docs/Mozilla/Projects/Thunderbird	/docs/en/Thunderbird
/pt-PT/docs/Mozilla/Tech/XUL	/pt-PT/docs/Archive/Mozilla/XUL
/pt-PT/docs/Mozilla/Tech/XUL/Attribute	/pt-PT/docs/XUL/Attribute
/pt-PT/docs/Mozilla/Tech/XUL/Comunidade	/pt-PT/docs/Archive/Mozilla/XUL/Comunidade
/pt-PT/docs/Mozilla/Tech/XUL/Namespaces	/pt-PT/docs/Archive/Mozilla/XUL/Namespaces
/pt-PT/docs/Mozilla/Tech/XUL/Outros_recursos	/pt-PT/docs/Archive/Mozilla/XUL/Outros_recursos
/pt-PT/docs/Mozilla/Tech/XUL/Tutorial	/pt-PT/docs/Archive/Mozilla/XUL/Tutorial
/pt-PT/docs/Mozilla/Tech/XUL/Tutorial/Adicionar_Etiquetas_e_Imagens	/pt-PT/docs/Archive/Mozilla/XUL/Tutorial/Adicionar_Etiquetas_e_Imagens
/pt-PT/docs/Mozilla/Tech/XUL/Tutorial/Ficheiros_de_propriedade	/pt-PT/docs/Archive/Mozilla/XUL/Tutorial/Ficheiros_de_propriedade
/pt-PT/docs/Mozilla/Tech/XUL/Tutorial/Modificar_o_tema_predefinido	/pt-PT/docs/Archive/Mozilla/XUL/Tutorial/Modificar_o_tema_predefinido
/pt-PT/docs/Mozilla/Tech/XUL/Tutorial/XBL_bindings	/pt-PT/docs/Archive/Mozilla/XUL/Tutorial/XBL_bindings
/pt-PT/docs/Mozilla/Tech/XUL/image	/pt-PT/docs/Archive/Mozilla/XUL/image
/pt-PT/docs/Mozilla/Tech/XUL/scale	/pt-PT/docs/Archive/Mozilla/XUL/scale
/pt-PT/docs/Namespaces	/pt-PT/docs/Mozilla/Tech/XUL/Namespaces
/pt-PT/docs/Normas_Web	/pt-PT/docs/Archive/Normas_Web
/pt-PT/docs/Novidades_no_Javascript_1.8	/pt-PT/docs/JavaScript/Novidades_no_JavaScript/Novidades_no_Javascript_1.8
/pt-PT/docs/Persona	/pt-PT/docs/Mozilla/Persona
/pt-PT/docs/Project:Como_Ajudar	/pt-PT/docs/Projeto:Como_ajudar
/pt-PT/docs/Project:Como_começar	/pt-PT/docs/MDN/Contribute/Howto
/pt-PT/docs/Project:Comunidade	/pt-PT/docs/MDN/Comunidade
/pt-PT/docs/Project:Direitos_de_autor	/docs/Project:pt/Copyrights
/pt-PT/docs/Project:Exemplos:Informações_Sobre_o_Documento_Original	/docs/Project:pt/Exemplos/Informa%C3%A7%C3%B5es_Sobre_o_Documento_Original
/pt-PT/docs/Project:FAQ	/docs/Project:pt/Perguntas_Frequentes
/pt-PT/docs/Project:Lista_de_Afazeres	/pt-PT/docs/MDN
/pt-PT/docs/Project:Predefinições_personalizadas	/pt-PT/docs/MDN
/pt-PT/docs/Promover_o_MDC	/docs/Project:pt/Promover_o_MDC
/pt-PT/docs/Página_principal	/docs/pt
/pt-PT/docs/RSS	/pt-PT/docs/Archive/RSS
/pt-PT/docs/RSS/Como_começar	/pt-PT/docs/Archive/RSS/Como_come%C3%A7ar
/pt-PT/docs/RSS/Como_começar/Como_o_RSS_trabalha	/pt-PT/docs/Archive/RSS/Como_come%C3%A7ar/Como_o_RSS_trabalha
/pt-PT/docs/RSS/Como_começar/O_que_é_RSS	/pt-PT/docs/Archive/RSS/Como_come%C3%A7ar/O_que_%C3%A9_RSS
/pt-PT/docs/RSS/Como_começar/Porque_usar_RSS	/pt-PT/docs/Archive/RSS/Como_come%C3%A7ar/Porque_usar_RSS
/pt-PT/docs/RSS/Como_começar/Sindicar	/pt-PT/docs/Archive/RSS/Como_come%C3%A7ar/Sindicar
/pt-PT/docs/RSS/Versão	/pt-PT/docs/Archive/RSS/Vers%C3%A3o
/pt-PT/docs/RSS/Versão/0.90	/pt-PT/docs/Archive/RSS/Vers%C3%A3o/0.90
/pt-PT/docs/RSS:Como_começar	/docs/pt/RSS/Como_come%C3%A7ar
/pt-PT/docs/RSS:Como_começar:Como_o_RSS_trabalha	/docs/pt/RSS/Como_come%C3%A7ar/Como_o_RSS_trabalha
/pt-PT/docs/RSS:Como_começar:O_que_é_RSS	/docs/pt/RSS/Como_come%C3%A7ar/O_que_%C3%A9_RSS
/pt-PT/docs/RSS:Como_começar:Porque_usar_RSS	/docs/pt/RSS/Como_come%C3%A7ar/Porque_usar_RSS
/pt-PT/docs/RSS:Como_começar:Sindicar	/docs/pt/RSS/Como_come%C3%A7ar/Sindicar
/pt-PT/docs/Referência_CSS	/pt-PT/docs/Web/CSS/Refer%C3%AAncia_CSS
/pt-PT/docs/Referência_CSS:Propriedades_do_modelo	/docs/pt/Refer%C3%AAncia_CSS/Propriedades_do_modelo
/pt-PT/docs/Referência_do_DOM_Gecko	/pt-PT/docs/Web/API/Document_Object_Model
/pt-PT/docs/Referência_do_DOM_Gecko:Prefácio	/docs/pt/Refer%C3%AAncia_do_DOM_Gecko/Pref%C3%A1cio
/pt-PT/docs/SVG	/pt-PT/docs/Web/SVG
/pt-PT/docs/SVG/Tutorial	/pt-PT/docs/Web/SVG/Tutorial
/pt-PT/docs/SVG:Comunidade	/docs/pt/SVG/Comunidade
/pt-PT/docs/SVG:Outros_recursos	/docs/pt/SVG/Outros_recursos
/pt-PT/docs/Sandbox:Test_Page	/docs/pt/Sandbox/Test_Page
/pt-PT/docs/Segurança	/pt-PT/docs/Web/Security
/pt-PT/docs/Sobreposições_XUL	/pt-PT/docs/Mozilla/Tech/XUL/Sobreposi%C3%A7%C3%B5es_XUL
/pt-PT/docs/SpiderMonkey	/pt-PT/docs/Mozilla/Projects/SpiderMonkey
/pt-PT/docs/Temas	/pt-PT/Add-ons/Themes
/pt-PT/docs/Tools/Simulador_do_SO_Firefox	/pt-PT/docs/Archive/B2G_OS/Simulator
/pt-PT/docs/Transformar_XML_com_XSLT:Para_leitura_adicional	/docs/pt/Transformar_XML_com_XSLT/Para_leitura_adicional
/pt-PT/docs/Tutorial_XUL:Adicionando_botões	/docs/pt/Tutorial_XUL/Adicionando_bot%C3%B5es
/pt-PT/docs/Tutorial_XUL:Criando_uma_janela	/docs/pt/Tutorial_XUL/Criando_uma_janela
/pt-PT/docs/Tutorial_XUL:Introdução	/docs/pt/Tutorial_XUL/Introdu%C3%A7%C3%A3o
/pt-PT/docs/Tutorial_do_Canvas:_Utilização_básica	/docs/pt/Tutorial_do_Canvas/Utiliza%C3%A7%C3%A3o_b%C3%A1sica
/pt-PT/docs/Usando_o_Núcleo_DOM_Nível_1_do_W3C	/pt-PT/docs/Using_the_W3C_DOM_Level_1_Core
/pt-PT/docs/Utilização_CXX_no_código_da_Mozilla	/pt-PT/docs/Mozilla/Utiliza%C3%A7%C3%A3o_CXX_no_c%C3%B3digo_da_Mozilla
/pt-PT/docs/Web/Apps/Progressiva	/pt-PT/docs/Web/Progressive_web_apps
/pt-PT/docs/Web/Apps/Progressiva/Identificavel	/pt-PT/docs/Web/Progressive_web_apps/Identificavel
/pt-PT/docs/Web/Apps/Progressiva/Responsivo	/pt-PT/docs/Web/Progressive_web_apps/Responsivo
/pt-PT/docs/Web/Apps/Progressive/Seguro	/pt-PT/docs/Web/Progressive_web_apps/Seguro
/pt-PT/docs/Web/CSS/CSS3	/pt-PT/docs/Archive/CSS3
/pt-PT/docs/Web/CSS/CSS_Colors	/en-US/docs/Web/CSS/CSS_Color
/pt-PT/docs/Web/CSS/Como_começar/XBL_bindings	/pt-PT/docs/XUL/Tutorial/XBL_bindings
/pt-PT/docs/Web/CSS/Múltiplos_fundos	/pt-PT/docs/CSS/M%C3%BAltiplos_planos_de_fundo
/pt-PT/docs/Web/CSS/Múltiplos_planos_de_fundo	/pt-PT/docs/Web/CSS/CSS_Background_and_Borders/M%C3%BAltiplos_planos_de_fundo
/pt-PT/docs/Web/Eventos/visibilitychange	/pt-PT/docs/Web/API/Document/visibilitychange_event
/pt-PT/docs/Web/Guide/CSS	/pt-PT/docs/Learn/CSS
/pt-PT/docs/Web/Guide/HTML	/pt-PT/docs/Learn/HTML
/pt-PT/docs/Web/Guide/HTML/Introduction	/pt-PT/docs/Learn/HTML/Introducao_ao_HTML
/pt-PT/docs/Web/HTML/Aplicar_cor__elementos_HTML_utilizando_CSS	/pt-PT/docs/HTMLToDelete/Aplicar_cor__elementos_HTML_utilizando_CSS
/pt-PT/docs/Web/HTML/Element	/pt-PT/docs/HTMLToDelete/Element
/pt-PT/docs/Web/HTML/Element/Audio	/pt-PT/docs/HTMLToDelete/Element/Audio
/pt-PT/docs/Web/HTML/Element/figure	/pt-PT/docs/HTMLToDelete/Element/figure
/pt-PT/docs/Web/HTML/Element/progress	/pt-PT/docs/HTMLToDelete/Element/progress
/pt-PT/docs/Web/HTML_Linguagem_de_marcacao_de_hipertexto	/pt-PT/docs/Web/HTML
/pt-PT/docs/Web/JavaScript/New_in_JavaScript	/pt-PT/docs/JavaScript/Novidades_no_JavaScript
/pt-PT/docs/XBL	/pt-PT/docs/Archive/Mozilla/XBL
/pt-PT/docs/XForms:Controles_Customizados	/docs/pt/XForms/Controles_Customizados
/pt-PT/docs/XML:Comunidade	/docs/pt/XML/Comunidade
/pt-PT/docs/XML:Outros_Recursos	/docs/pt/XML/Outros_Recursos
/pt-PT/docs/XML_Web_Services	/en-US/docs/Archive/Mozilla/Firefox/SOAP_in_Gecko-based_Browsers
/pt-PT/docs/XPCOM	/pt-PT/docs/Mozilla/Tech/XPCOM
/pt-PT/docs/XPInstall	/pt-PT/docs/XPInstall
/pt-PT/docs/XPath	/pt-PT/docs/Web/XPath
/pt-PT/docs/XPath:Eixos	/docs/pt/XPath/Eixos
/pt-PT/docs/XPath:Funções	/docs/pt/XPath/Fun%C3%A7%C3%B5es
/pt-PT/docs/XSLT	/pt-PT/docs/Web/XSLT
/pt-PT/docs/XSLT/Comunidade	/pt-PT/docs/Web/XSLT/Comunidade
/pt-PT/docs/XSLT/Elementos	/pt-PT/docs/Web/XSLT/Elementos
/pt-PT/docs/XSLT:Comunidade	/docs/pt/XSLT/Comunidade
/pt-PT/docs/XSLT:Elementos	/docs/pt/XSLT/Elementos
/pt-PT/docs/XUL	/pt-PT/docs/Mozilla/Tech/XUL
/pt-PT/docs/XUL/Comunidade	/pt-PT/docs/Mozilla/Tech/XUL/Comunidade
/pt-PT/docs/XUL/Outros_recursos	/pt-PT/docs/Mozilla/Tech/XUL/Outros_recursos
/pt-PT/docs/XUL/Toolbars	/pt-PT/docs/Mozilla/Tech/XUL/Tutorial
/pt-PT/docs/XUL/Toolbars/XBL_bindings	/pt-PT/docs/Mozilla/Tech/XUL/Tutorial/XBL_bindings
/pt-PT/docs/XUL/Tutorial	/pt-PT/docs/Mozilla/Tech/XUL/Tutorial
/pt-PT/docs/XUL/Tutorial/XBL_bindings	/pt-PT/docs/Mozilla/Tech/XUL/Tutorial/XBL_bindings
/pt-PT/docs/XUL/scale	/pt-PT/docs/Mozilla/Tech/XUL/scale
/pt-PT/docs/XUL:Attribute:textbox.type	/docs/pt/XUL/Attribute/textbox.type
/pt-PT/docs/XUL:Comunidade	/docs/pt/XUL/Comunidade
/pt-PT/docs/XUL:Outros_recursos	/docs/pt/XUL/Outros_recursos
/pt-PT/docs/XUL:scale	/docs/pt/XUL/scale
/pt-PT/docs/XULRunner	/pt-PT/docs/Archive/Mozilla/XULRunner
/pt-PT/docs/en	/
/pt-PT/docs/manipuladores_de_protocolos_baseados_na_web	/docs/pt/Manipuladores_de_protocolo_web
